худой кадык	[['худой', {'дат,ед', 'род,ед', 'пр,ед', 'им,ед', 'твор,ед', 'вин,ед'}], ['кадык', {'им,ед', 'вин,ед'}]]
худых земель	[['худой', {'пр,мн', 'вин,мн', 'род,мн'}], ['земля', {'род,мн'}]]
худые плечики	[['худой', {'вин,мн', 'им,мн'}], ['плечики', {'вин,мн', 'им,мн'}]]
худым коленям	[['худой', {'дат,мн', 'твор,ед'}], ['колено', {'дат,мн'}]]
худое сообщество	[['худой', {'им,ед', 'вин,ед'}], ['сообщество', {'им,ед', 'вин,ед'}]]
худого гнезда	[['худой', {'род,ед', 'вин,ед'}], ['гнездо', {'род,ед', 'вин,мн', 'им,мн'}]]
худая пища	[['худой', {'им,ед'}], ['пища', {'им,ед'}]]
худой знакъ	[['худой', {'дат,ед', 'род,ед', 'пр,ед', 'им,ед', 'твор,ед', 'вин,ед'}], ['знак', {'им,ед', 'вин,ед'}]]
худое понятие	[['худой', {'им,ед', 'вин,ед'}], ['понятие', {'им,ед', 'вин,ед'}]]
худая цыганка	[['худой', {'им,ед'}], ['цыганка', {'им,ед'}]]
худыми боками	[['худой', {'твор,мн'}], ['бок', {'твор,мн'}]]
худой инженер	[['худой', {'дат,ед', 'род,ед', 'пр,ед', 'им,ед', 'твор,ед', 'вин,ед'}], ['инженер', {'им,ед'}]]
худом аскетическом	[['худой', {'пр,ед'}], ['аскетический', set()]]
худых авторов	[['худой', {'пр,мн', 'вин,мн', 'род,мн'}], ['автор', {'вин,мн', 'род,мн'}]]
худую роль	[['худой', {'вин,ед'}], ['роль', {'им,ед', 'вин,ед'}]]
худыми крышами	[['худой', {'твор,мн'}], ['крыша', {'твор,мн'}]]
худое распоряжение	[['худой', {'им,ед', 'вин,ед'}], ['распоряжение', {'им,ед', 'вин,ед'}]]
худых ног	[['худой', {'пр,мн', 'вин,мн', 'род,мн'}], ['нога', {'род,мн'}]]
худом пальтишке	[['худой', {'пр,ед'}], ['пальтишко', {'пр,ед'}]]
худого юношу	[['худой', {'род,ед', 'вин,ед'}], ['юноша', {'вин,ед'}]]
худой головой	[['худой', {'дат,ед', 'род,ед', 'пр,ед', 'им,ед', 'твор,ед', 'вин,ед'}], ['голова', {'твор,ед'}]]
худых речей	[['худой', {'пр,мн', 'вин,мн', 'род,мн'}], ['речь', {'род,мн'}]]
худых плечах	[['худой', {'пр,мн', 'вин,мн', 'род,мн'}], ['плечо', {'пр,мн'}]]
худые нравы	[['худой', {'вин,мн', 'им,мн'}], ['нрав', {'вин,мн', 'им,мн'}]]
худая старушка	[['худой', {'им,ед'}], ['старушка', {'им,ед'}]]
худыми примерами	[['худой', {'твор,мн'}], ['пример', {'твор,мн'}]]
худое риторство	[['худой', {'им,ед', 'вин,ед'}], ['риторство', {'им,ед', 'вин,ед'}]]
худой поступок	[['худой', {'дат,ед', 'род,ед', 'пр,ед', 'им,ед', 'твор,ед', 'вин,ед'}], ['поступок', {'им,ед', 'вин,ед'}]]
худой паренек	[['худой', {'дат,ед', 'род,ед', 'пр,ед', 'им,ед', 'твор,ед', 'вин,ед'}], ['паренек', {'им,ед'}]]
худою погодою	[['худой', {'твор,ед'}], ['погода', {'твор,ед'}]]
худые скулы	[['худой', {'вин,мн', 'им,мн'}], ['скула', {'род,ед', 'вин,мн', 'им,мн'}]]
худое состоите	[['худой', {'им,ед', 'вин,ед'}], ['состоять', set()]]
худую картину	[['худой', {'вин,ед'}], ['картина', {'вин,ед'}]]
худые ноги	[['худой', {'вин,мн', 'им,мн'}], ['нога', {'род,ед', 'вин,мн', 'им,мн'}]]
худым средствам	[['худой', {'дат,мн', 'твор,ед'}], ['средство', {'дат,мн'}]]
худых лиц	[['худой', {'пр,мн', 'вин,мн', 'род,мн'}], ['лицо', {'род,мн'}]]
худые дворяне	[['худой', {'вин,мн', 'им,мн'}], ['дворянин', {'им,мн'}]]
худых обстоятельств	[['худой', {'пр,мн', 'вин,мн', 'род,мн'}], ['обстоятельство', {'род,мн'}]]
худых пальцах	[['худой', {'пр,мн', 'вин,мн', 'род,мн'}], ['палец', {'пр,мн'}]]
худому концу	[['худой', {'дат,ед'}], ['конец', {'дат,ед'}]]
худых землях	[['худой', {'пр,мн', 'вин,мн', 'род,мн'}], ['земля', {'пр,мн'}]]
худую фигурку	[['худой', {'вин,ед'}], ['фигурка', {'вин,ед'}]]
худой коней	[['худой', {'дат,ед', 'род,ед', 'пр,ед', 'им,ед', 'твор,ед', 'вин,ед'}], ['конь', {'вин,мн', 'род,мн'}]]
худым кулаком	[['худой', {'дат,мн', 'твор,ед'}], ['кулак', {'твор,ед'}]]
худому поведению	[['худой', {'дат,ед'}], ['поведение', {'дат,ед'}]]
худой женщиной	[['худой', {'дат,ед', 'род,ед', 'пр,ед', 'им,ед', 'твор,ед', 'вин,ед'}], ['женщина', {'твор,ед'}]]
худой кафтан	[['худой', {'дат,ед', 'род,ед', 'пр,ед', 'им,ед', 'твор,ед', 'вин,ед'}], ['кафтан', {'им,ед', 'вин,ед'}]]
худого смерда	[['худой', {'род,ед', 'вин,ед'}], ['смерд', {'род,ед', 'вин,ед'}]]
худых валенках	[['худой', {'пр,мн', 'вин,мн', 'род,мн'}], ['валенок', {'пр,мн'}]]
худыми переводами	[['худой', {'твор,мн'}], ['перевод', {'твор,мн'}]]
худые последствия	[['худой', {'вин,мн', 'им,мн'}], ['последствие', {'род,ед', 'вин,мн', 'им,мн'}]]
худом воре	[['худой', {'пр,ед'}], ['вор', {'пр,ед'}]]
худые стихи	[['худой', {'вин,мн', 'им,мн'}], ['стих', {'вин,мн', 'им,мн'}]]
худой конецъ	[['худой', {'дат,ед', 'род,ед', 'пр,ед', 'им,ед', 'твор,ед', 'вин,ед'}], ['конец', {'им,ед', 'вин,ед'}]]
худую руку	[['худой', {'вин,ед'}], ['рука', {'вин,ед'}]]
худую бабу	[['худой', {'вин,ед'}], ['баба', {'вин,ед'}]]
худую землю	[['худой', {'вин,ед'}], ['земля', {'вин,ед'}]]
худых детей	[['худой', {'пр,мн', 'вин,мн', 'род,мн'}], ['ребенок', {'вин,мн', 'род,мн'}]]
худое запястье	[['худой', {'им,ед', 'вин,ед'}], ['запястье', {'пр,ед', 'им,ед', 'вин,ед'}]]
худых дорог	[['худой', {'пр,мн', 'вин,мн', 'род,мн'}], ['дорогой', set()]]
худом стихосложении	[['худой', {'пр,ед'}], ['стихосложение', {'пр,ед'}]]
худой подросток	[['худой', {'дат,ед', 'род,ед', 'пр,ед', 'им,ед', 'твор,ед', 'вин,ед'}], ['подросток', {'им,ед'}]]
худой приметой	[['худой', {'дат,ед', 'род,ед', 'пр,ед', 'им,ед', 'твор,ед', 'вин,ед'}], ['примета', {'твор,ед'}]]
худых плеч	[['худой', {'пр,мн', 'вин,мн', 'род,мн'}], ['плечо', {'род,мн'}]]
худых коней	[['худой', {'пр,мн', 'вин,мн', 'род,мн'}], ['конь', {'вин,мн', 'род,мн'}]]
худую одежонку	[['худой', {'вин,ед'}], ['одежонка', {'вин,ед'}]]
худое учение	[['худой', {'им,ед', 'вин,ед'}], ['учение', {'им,ед', 'вин,ед'}]]
худой час	[['худой', {'дат,ед', 'род,ед', 'пр,ед', 'им,ед', 'твор,ед', 'вин,ед'}], ['час', {'им,ед', 'вин,ед'}]]
худую услугу	[['худой', {'вин,ед'}], ['услуга', {'вин,ед'}]]
худую кисть	[['худой', {'вин,ед'}], ['кисть', {'им,ед', 'вин,ед'}]]
худые люди	[['худой', {'вин,мн', 'им,мн'}], ['человек', {'им,мн'}]]
худой фигурой	[['худой', {'дат,ед', 'род,ед', 'пр,ед', 'им,ед', 'твор,ед', 'вин,ед'}], ['фигура', {'твор,ед'}]]
худой мир	[['худой', {'дат,ед', 'род,ед', 'пр,ед', 'им,ед', 'твор,ед', 'вин,ед'}], ['мир', {'им,ед', 'вин,ед'}]]
худых поступок	[['худой', {'пр,мн', 'вин,мн', 'род,мн'}], ['поступок', {'им,ед', 'вин,ед'}]]
худой еврей	[['худой', {'дат,ед', 'род,ед', 'пр,ед', 'им,ед', 'твор,ед', 'вин,ед'}], ['еврей', {'им,ед'}]]
худое расположение	[['худой', {'им,ед', 'вин,ед'}], ['расположение', {'им,ед', 'вин,ед'}]]
худых людях	[['худой', {'пр,мн', 'вин,мн', 'род,мн'}], ['человек', {'пр,мн'}]]
худое ремесло	[['худой', {'им,ед', 'вин,ед'}], ['ремесло', {'им,ед', 'вин,ед'}]]
худые товары	[['худой', {'вин,мн', 'им,мн'}], ['товар', {'вин,мн', 'им,мн'}]]
худого человека	[['худой', {'род,ед', 'вин,ед'}], ['человек', {'род,ед', 'вин,ед'}]]
худы стали	[['худой', {'мн,кр'}], ['становиться', set()]]
худой знак	[['худой', {'дат,ед', 'род,ед', 'пр,ед', 'им,ед', 'твор,ед', 'вин,ед'}], ['знак', {'им,ед', 'вин,ед'}]]
худыми плечами	[['худой', {'твор,мн'}], ['плечо', {'твор,мн'}]]
худой ты	[['худой', {'дат,ед', 'род,ед', 'пр,ед', 'им,ед', 'твор,ед', 'вин,ед'}], ['ты', {'им,ед'}]]
худыя привычки	[['худой', {'вин,мн', 'им,мн'}], ['привычка', {'род,ед', 'вин,мн', 'им,мн'}]]
худая обувь	[['худой', {'им,ед'}], ['обувь', {'им,ед', 'вин,ед'}]]
худыя мысли	[['худой', {'вин,мн', 'им,мн'}], ['мысль', {'род,ед', 'дат,ед', 'пр,ед', 'вин,мн', 'им,мн'}]]
худой мужик	[['худой', {'дат,ед', 'род,ед', 'пр,ед', 'им,ед', 'твор,ед', 'вин,ед'}], ['мужик', {'им,ед'}]]
худомъ счету	[['худой', {'пр,ед'}], ['счет', {'дат,ед', 'парт,ед'}]]
худая баба	[['худой', {'им,ед'}], ['баба', {'им,ед'}]]
худыми плечиками	[['худой', {'твор,мн'}], ['плечики', {'твор,мн'}]]
худой поэт	[['худой', {'дат,ед', 'род,ед', 'пр,ед', 'им,ед', 'твор,ед', 'вин,ед'}], ['поэт', {'им,ед'}]]
худых мест	[['худой', {'пр,мн', 'вин,мн', 'род,мн'}], ['место', {'род,мн'}]]
худым знанием	[['худой', {'дат,мн', 'твор,ед'}], ['знание', {'твор,ед'}]]
худая грудь	[['худой', {'им,ед'}], ['грудь', {'им,ед', 'вин,ед'}]]
худых следствий	[['худой', {'пр,мн', 'вин,мн', 'род,мн'}], ['следствие', {'род,мн'}]]
худого зада	[['худой', {'род,ед', 'вин,ед'}], ['зад', {'род,ед'}]]
худое положеше	[['худой', {'им,ед', 'вин,ед'}], ['положеш', {'пр,ед'}]]
худыя места	[['худой', {'вин,мн', 'им,мн'}], ['место', {'род,ед', 'вин,мн', 'им,мн'}]]
худого она	[['худой', {'род,ед', 'вин,ед'}], ['она', {'им,ед'}]]
худыми качествами	[['худой', {'твор,мн'}], ['качество', {'твор,мн'}]]
худое содержание	[['худой', {'им,ед', 'вин,ед'}], ['содержание', {'им,ед', 'вин,ед'}]]
худых руках	[['худой', {'пр,мн', 'вин,мн', 'род,мн'}], ['рука', {'пр,мн'}]]
худом качестве	[['худой', {'пр,ед'}], ['качество', {'пр,ед'}]]
худую лодку	[['худой', {'вин,ед'}], ['лодка', {'вин,ед'}]]
худой брат	[['худой', {'дат,ед', 'род,ед', 'пр,ед', 'им,ед', 'твор,ед', 'вин,ед'}], ['брат', {'им,ед'}]]
худом мире	[['худой', {'пр,ед'}], ['мир', {'пр,ед'}]]
худой обуви	[['худой', {'дат,ед', 'род,ед', 'пр,ед', 'им,ед', 'твор,ед', 'вин,ед'}], ['обувь', {'род,ед', 'дат,ед', 'пр,ед', 'вин,мн', 'им,мн'}]]
худых мальчиков	[['худой', {'пр,мн', 'вин,мн', 'род,мн'}], ['мальчик', {'вин,мн', 'род,мн'}]]
худую квартиру	[['худой', {'вин,ед'}], ['квартира', {'вин,ед'}]]
худые земли	[['худой', {'вин,мн', 'им,мн'}], ['земля', {'род,ед', 'вин,мн', 'им,мн'}]]
худого дерева	[['худой', {'род,ед', 'вин,ед'}], ['дерево', {'род,ед', 'вин,мн', 'им,мн'}]]
худой курицы	[['худой', {'дат,ед', 'род,ед', 'пр,ед', 'им,ед', 'твор,ед', 'вин,ед'}], ['курица', {'род,ед', 'им,мн'}]]
худого глазу	[['худой', {'род,ед', 'вин,ед'}], ['глаз', {'дат,ед', 'местн,ед'}]]
худыя земли	[['худой', {'вин,мн', 'им,мн'}], ['земля', {'род,ед', 'вин,мн', 'им,мн'}]]
худое белье	[['худой', {'им,ед', 'вин,ед'}], ['белье', {'пр,ед', 'им,ед', 'вин,ед'}]]
худая мать	[['худой', {'им,ед'}], ['мать', {'им,ед', 'вин,ед'}]]
худой волк	[['худой', {'дат,ед', 'род,ед', 'пр,ед', 'им,ед', 'твор,ед', 'вин,ед'}], ['волк', {'им,ед'}]]
худыми лицами	[['худой', {'твор,мн'}], ['лицо', {'твор,мн'}]]
худой пище	[['худой', {'дат,ед', 'род,ед', 'пр,ед', 'им,ед', 'твор,ед', 'вин,ед'}], ['пища', {'пр,ед', 'дат,ед'}]]
худая кляча	[['худой', {'им,ед'}], ['кляча', {'им,ед'}]]
худые дела	[['худой', {'вин,мн', 'им,мн'}], ['дело', {'род,ед', 'вин,мн', 'им,мн'}]]
худой подбородок	[['худой', {'дат,ед', 'род,ед', 'пр,ед', 'им,ед', 'твор,ед', 'вин,ед'}], ['подбородок', {'им,ед', 'вин,ед'}]]
худой действительности	[['худой', {'дат,ед', 'род,ед', 'пр,ед', 'им,ед', 'твор,ед', 'вин,ед'}], ['действительность', {'род,ед', 'дат,ед', 'пр,ед', 'вин,мн', 'им,мн'}]]
худого мужика	[['худой', {'род,ед', 'вин,ед'}], ['мужик', {'род,ед', 'вин,ед'}]]
худыми людишками	[['худой', {'твор,мн'}], ['людишки', {'твор,мн'}]]
худая Сонька	[['худой', {'им,ед'}], ['сонька', {'им,ед'}]]
худые тела	[['худой', {'вин,мн', 'им,мн'}], ['тело', {'род,ед', 'вин,мн', 'им,мн'}]]
худой работы	[['худой', {'дат,ед', 'род,ед', 'пр,ед', 'им,ед', 'твор,ед', 'вин,ед'}], ['работа', {'род,ед', 'вин,мн', 'им,мн'}]]
худой забор	[['худой', {'дат,ед', 'род,ед', 'пр,ед', 'им,ед', 'твор,ед', 'вин,ед'}], ['забор', {'им,ед', 'вин,ед'}]]
худой арестант	[['худой', {'дат,ед', 'род,ед', 'пр,ед', 'им,ед', 'твор,ед', 'вин,ед'}], ['арестант', {'им,ед'}]]
худая фигурка	[['худой', {'им,ед'}], ['фигурка', {'им,ед'}]]
худой собаки	[['худой', {'дат,ед', 'род,ед', 'пр,ед', 'им,ед', 'твор,ед', 'вин,ед'}], ['собака', {'род,ед', 'им,мн'}]]
худом месте	[['худой', {'пр,ед'}], ['место', {'пр,ед'}]]
худой женщины	[['худой', {'дат,ед', 'род,ед', 'пр,ед', 'им,ед', 'твор,ед', 'вин,ед'}], ['женщина', {'род,ед', 'им,мн'}]]
худую коленку	[['худой', {'вин,ед'}], ['коленка', {'вин,ед'}]]
худом поведении	[['худой', {'пр,ед'}], ['поведение', {'пр,ед'}]]
худой одежды	[['худой', {'дат,ед', 'род,ед', 'пр,ед', 'им,ед', 'твор,ед', 'вин,ед'}], ['одежда', {'род,ед', 'вин,мн', 'им,мн'}]]
худое дерево	[['худой', {'им,ед', 'вин,ед'}], ['дерево', {'им,ед', 'вин,ед'}]]
худой доброты	[['худой', {'дат,ед', 'род,ед', 'пр,ед', 'им,ед', 'твор,ед', 'вин,ед'}], ['доброта', {'род,ед', 'вин,мн', 'им,мн'}]]
худая действительность	[['худой', {'им,ед'}], ['действительность', {'им,ед', 'вин,ед'}]]
худою травою	[['худой', {'твор,ед'}], ['трава', {'твор,ед'}]]
худом теле	[['худой', {'пр,ед'}], ['тело', {'пр,ед'}]]
худыми ключицами	[['худой', {'твор,мн'}], ['ключица', {'твор,мн'}]]
худой вещмешок	[['худой', {'дат,ед', 'род,ед', 'пр,ед', 'им,ед', 'твор,ед', 'вин,ед'}], ['вещмешок', {'им,ед', 'вин,ед'}]]
худую ручонку	[['худой', {'вин,ед'}], ['ручонка', {'вин,ед'}]]
худого мне	[['худой', {'род,ед', 'вин,ед'}], ['я', {'пр,ед', 'дат,ед'}]]
худым умишком	[['худой', {'дат,мн', 'твор,ед'}], ['умишко', {'твор,ед'}]]
худые проводники	[['худой', {'вин,мн', 'им,мн'}], ['проводник', {'им,мн'}]]
худой капитан	[['худой', {'дат,ед', 'род,ед', 'пр,ед', 'им,ед', 'твор,ед', 'вин,ед'}], ['капитан', {'им,ед'}]]
худая беседа	[['худой', {'им,ед'}], ['беседа', {'им,ед'}]]
худой офицер	[['худой', {'дат,ед', 'род,ед', 'пр,ед', 'им,ед', 'твор,ед', 'вин,ед'}], ['офицер', {'им,ед'}]]
худое обращение	[['худой', {'им,ед', 'вин,ед'}], ['обращение', {'им,ед', 'вин,ед'}]]
худом коне	[['худой', {'пр,ед'}], ['конь', {'пр,ед'}]]
худой год	[['худой', {'дат,ед', 'род,ед', 'пр,ед', 'им,ед', 'твор,ед', 'вин,ед'}], ['год', {'им,ед', 'вин,ед'}]]
худой грузин	[['худой', {'дат,ед', 'род,ед', 'пр,ед', 'им,ед', 'твор,ед', 'вин,ед'}], ['грузин', {'им,ед', 'вин,мн', 'род,мн'}]]
худые дети	[['худой', {'вин,мн', 'им,мн'}], ['ребенок', {'им,мн'}]]
худыми дорогами	[['худой', {'твор,мн'}], ['дорога', {'твор,мн'}]]
худой стих	[['худой', {'дат,ед', 'род,ед', 'пр,ед', 'им,ед', 'твор,ед', 'вин,ед'}], ['стих', {'им,ед', 'вин,ед'}]]
худую свинью	[['худой', {'вин,ед'}], ['свинья', {'вин,ед'}]]
худая молва	[['худой', {'им,ед'}], ['молва', {'им,ед'}]]
худой пример	[['худой', {'дат,ед', 'род,ед', 'пр,ед', 'им,ед', 'твор,ед', 'вин,ед'}], ['пример', {'им,ед', 'вин,ед'}]]
худой люди	[['худой', {'дат,ед', 'род,ед', 'пр,ед', 'им,ед', 'твор,ед', 'вин,ед'}], ['человек', {'им,мн'}]]
худого коня	[['худой', {'род,ед', 'вин,ед'}], ['конь', {'род,ед', 'вин,ед'}]]
худой военный	[['худой', {'дат,ед', 'род,ед', 'пр,ед', 'им,ед', 'твор,ед', 'вин,ед'}], ['военный', set()]]
худое правление	[['худой', {'им,ед', 'вин,ед'}], ['правление', {'им,ед', 'вин,ед'}]]
худой горшок	[['худой', {'дат,ед', 'род,ед', 'пр,ед', 'им,ед', 'твор,ед', 'вин,ед'}], ['горшок', {'им,ед', 'вин,ед'}]]
худым намерением	[['худой', {'дат,мн', 'твор,ед'}], ['намерение', {'твор,ед'}]]
худых сапогах	[['худой', {'пр,мн', 'вин,мн', 'род,мн'}], ['сапог', {'пр,мн'}]]
худым стариком	[['худой', {'дат,мн', 'твор,ед'}], ['старик', {'твор,ед'}]]
худого он	[['худой', {'род,ед', 'вин,ед'}], ['он', {'им,ед'}]]
худой конец	[['худой', {'дат,ед', 'род,ед', 'пр,ед', 'им,ед', 'твор,ед', 'вин,ед'}], ['конец', {'им,ед', 'вин,ед'}]]
худые валенки	[['худой', {'вин,мн', 'им,мн'}], ['валенок', {'вин,мн', 'им,мн'}]]
худые обычаи	[['худой', {'вин,мн', 'им,мн'}], ['обычай', {'вин,мн', 'им,мн'}]]
худой товар	[['худой', {'дат,ед', 'род,ед', 'пр,ед', 'им,ед', 'твор,ед', 'вин,ед'}], ['товар', {'им,ед', 'вин,ед'}]]
худых конях	[['худой', {'пр,мн', 'вин,мн', 'род,мн'}], ['конь', {'пр,мн'}]]
худой кот	[['худой', {'дат,ед', 'род,ед', 'пр,ед', 'им,ед', 'твор,ед', 'вин,ед'}], ['кот', {'им,ед'}]]
худые результаты	[['худой', {'вин,мн', 'им,мн'}], ['результат', {'вин,мн', 'им,мн'}]]
худого никто	[['худой', {'род,ед', 'вин,ед'}], ['никто', {'им,ед'}]]
худой монах	[['худой', {'дат,ед', 'род,ед', 'пр,ед', 'им,ед', 'твор,ед', 'вин,ед'}], ['монах', {'им,ед'}]]
худой китаец	[['худой', {'дат,ед', 'род,ед', 'пр,ед', 'им,ед', 'твор,ед', 'вин,ед'}], ['китаец', {'им,ед'}]]
худыми лошадьми	[['худой', {'твор,мн'}], ['лошадь', {'твор,мн'}]]
худой травы	[['худой', {'дат,ед', 'род,ед', 'пр,ед', 'им,ед', 'твор,ед', 'вин,ед'}], ['трава', {'род,ед', 'вин,мн', 'им,мн'}]]
худые коровы	[['худой', {'вин,мн', 'им,мн'}], ['корова', {'род,ед', 'им,мн'}]]
худое здоровье	[['худой', {'им,ед', 'вин,ед'}], ['здоровье', {'пр,ед', 'им,ед', 'вин,ед'}]]
худое обращеше	[['худой', {'им,ед', 'вин,ед'}], ['обращеш', {'пр,ед'}]]
худую девушку	[['худой', {'вин,ед'}], ['девушка', {'вин,ед'}]]
худые кости	[['худой', {'вин,мн', 'им,мн'}], ['кость', {'род,ед', 'дат,ед', 'пр,ед', 'вин,мн', 'им,мн'}]]
худой верзила	[['худой', {'дат,ед', 'род,ед', 'пр,ед', 'им,ед', 'твор,ед', 'вин,ед'}], ['верзила', {'им,ед'}]]
худой жребий	[['худой', {'дат,ед', 'род,ед', 'пр,ед', 'им,ед', 'твор,ед', 'вин,ед'}], ['жребий', {'им,ед', 'вин,ед'}]]
худыми конями	[['худой', {'твор,мн'}], ['конь', {'твор,мн'}]]
худыя двла	[['худой', {'вин,мн', 'им,мн'}], ['двла', {'им,ед'}]]
худых людишек	[['худой', {'пр,мн', 'вин,мн', 'род,мн'}], ['людишки', {'вин,мн', 'род,мн'}]]
худая девка	[['худой', {'им,ед'}], ['девка', {'им,ед'}]]
худая жена	[['худой', {'им,ед'}], ['жена', {'им,ед'}]]
худых лошадях	[['худой', {'пр,мн', 'вин,мн', 'род,мн'}], ['лошадь', {'пр,мн'}]]
худая прислужка	[['худой', {'им,ед'}], ['прислужка', {'им,ед'}]]
худые привычки	[['худой', {'вин,мн', 'им,мн'}], ['привычка', {'род,ед', 'вин,мн', 'им,мн'}]]
худые колена	[['худой', {'вин,мн', 'им,мн'}], ['колено', {'род,ед', 'вин,мн', 'им,мн'}]]
худые номоканунцы	[['худой', {'вин,мн', 'им,мн'}], ['номоканунец', {'вин,мн', 'им,мн'}]]
худого решета	[['худой', {'род,ед', 'вин,ед'}], ['решето', {'род,ед', 'вин,мн', 'им,мн'}]]
худого ей	[['худой', {'род,ед', 'вин,ед'}], ['она', {'дат,ед', 'твор,ед'}]]
худое свойство	[['худой', {'им,ед', 'вин,ед'}], ['свойство', {'им,ед', 'вин,ед'}]]
худой ко	[['худой', {'дат,ед', 'род,ед', 'пр,ед', 'им,ед', 'твор,ед', 'вин,ед'}], ['ко', set()]]
худого старика	[['худой', {'род,ед', 'вин,ед'}], ['старик', {'род,ед', 'вин,ед'}]]
худого положения	[['худой', {'род,ед', 'вин,ед'}], ['положение', {'род,ед', 'вин,мн', 'им,мн'}]]
худая дама	[['худой', {'им,ед'}], ['дама', {'им,ед'}]]
худой лапоть	[['худой', {'дат,ед', 'род,ед', 'пр,ед', 'им,ед', 'твор,ед', 'вин,ед'}], ['лапоть', {'им,ед', 'вин,ед'}]]
худого лица	[['худой', {'род,ед', 'вин,ед'}], ['лицо', {'род,ед', 'вин,мн', 'им,мн'}]]
худой жене	[['худой', {'дат,ед', 'род,ед', 'пр,ед', 'им,ед', 'твор,ед', 'вин,ед'}], ['жена', {'пр,ед', 'дат,ед'}]]
худого мужчину	[['худой', {'род,ед', 'вин,ед'}], ['мужчина', {'вин,ед'}]]
худая мысль	[['худой', {'им,ед'}], ['мысль', {'им,ед', 'вин,ед'}]]
худых судей	[['худой', {'пр,мн', 'вин,мн', 'род,мн'}], ['судья', {'вин,мн', 'род,мн'}]]
худом порядке	[['худой', {'пр,ед'}], ['порядок', {'пр,ед'}]]
худой француз	[['худой', {'дат,ед', 'род,ед', 'пр,ед', 'им,ед', 'твор,ед', 'вин,ед'}], ['француз', {'им,ед'}]]
худой привычки	[['худой', {'дат,ед', 'род,ед', 'пр,ед', 'им,ед', 'твор,ед', 'вин,ед'}], ['привычка', {'род,ед', 'вин,мн', 'им,мн'}]]
худыми намерениями	[['худой', {'твор,мн'}], ['намерение', {'твор,мн'}]]
худому рабу	[['худой', {'дат,ед'}], ['раб', {'дат,ед'}]]
худом сюртуке	[['худой', {'пр,ед'}], ['сюртук', {'пр,ед'}]]
худом смысле	[['худой', {'пр,ед'}], ['смысл', {'пр,ед'}]]
худыя руки	[['худой', {'вин,мн', 'им,мн'}], ['рука', {'род,ед', 'вин,мн', 'им,мн'}]]
худого братца	[['худой', {'род,ед', 'вин,ед'}], ['братец', {'род,ед', 'вин,ед'}]]
худую весть	[['худой', {'вин,ед'}], ['весть', {'им,ед', 'вин,ед'}]]
худое состояше	[['худой', {'им,ед', 'вин,ед'}], ['состояш', {'пр,ед'}]]
худые башмаки	[['худой', {'вин,мн', 'им,мн'}], ['башмак', {'вин,мн', 'им,мн'}]]
худым делом	[['худой', {'дат,мн', 'твор,ед'}], ['дело', {'твор,ед'}]]
худого разума	[['худой', {'род,ед', 'вин,ед'}], ['разум', {'род,ед'}]]
худой почве	[['худой', {'дат,ед', 'род,ед', 'пр,ед', 'им,ед', 'твор,ед', 'вин,ед'}], ['почва', {'пр,ед', 'дат,ед'}]]
худого ты	[['худой', {'род,ед', 'вин,ед'}], ['ты', {'им,ед'}]]
худыя дъла	[['худой', {'вин,мн', 'им,мн'}], ['дъла', {'вин,мн', 'им,мн'}]]
худою дорогою	[['худой', {'твор,ед'}], ['дорога', {'твор,ед'}]]
худые горшки	[['худой', {'вин,мн', 'им,мн'}], ['горшок', {'вин,мн', 'им,мн'}]]
худою своею	[['худой', {'твор,ед'}], ['свой', set()]]
худое мнение	[['худой', {'им,ед', 'вин,ед'}], ['мнение', {'им,ед', 'вин,ед'}]]
худого подростка	[['худой', {'род,ед', 'вин,ед'}], ['подросток', {'род,ед', 'вин,ед'}]]
худые их	[['худой', {'вин,мн', 'им,мн'}], ['они', {'вин,мн', 'род,мн'}]]
худого дела	[['худой', {'род,ед', 'вин,ед'}], ['дело', {'род,ед', 'вин,мн', 'им,мн'}]]
худые ножки	[['худой', {'вин,мн', 'им,мн'}], ['ножка', {'род,ед', 'вин,мн', 'им,мн'}]]
худые бабы	[['худой', {'вин,мн', 'им,мн'}], ['баба', {'род,ед', 'им,мн'}]]
худой боец	[['худой', {'дат,ед', 'род,ед', 'пр,ед', 'им,ед', 'твор,ед', 'вин,ед'}], ['боец', {'им,ед'}]]
худую обувь	[['худой', {'вин,ед'}], ['обувь', {'им,ед', 'вин,ед'}]]
худые обстоятельства	[['худой', {'вин,мн', 'им,мн'}], ['обстоятельство', {'род,ед', 'вин,мн', 'им,мн'}]]
худой локоть	[['худой', {'дат,ед', 'род,ед', 'пр,ед', 'им,ед', 'твор,ед', 'вин,ед'}], ['локоть', {'им,ед', 'вин,ед'}]]
худое мнеше	[['худой', {'им,ед', 'вин,ед'}], ['мнеш', {'пр,ед'}]]
худыми ногами	[['худой', {'твор,мн'}], ['нога', {'твор,мн'}]]
худыхъ поступкахъ	[['худой', {'пр,мн', 'вин,мн', 'род,мн'}], ['поступок', {'пр,мн'}]]
худыми красками	[['худой', {'твор,мн'}], ['краска', {'твор,мн'}]]
худой обычай	[['худой', {'дат,ед', 'род,ед', 'пр,ед', 'им,ед', 'твор,ед', 'вин,ед'}], ['обычай', {'им,ед', 'вин,ед'}]]
худой лейтенант	[['худой', {'дат,ед', 'род,ед', 'пр,ед', 'им,ед', 'твор,ед', 'вин,ед'}], ['лейтенант', {'им,ед'}]]
худого парня	[['худой', {'род,ед', 'вин,ед'}], ['парень', {'род,ед', 'вин,ед'}]]
худому состоянию	[['худой', {'дат,ед'}], ['состояние', {'дат,ед'}]]
худой палец	[['худой', {'дат,ед', 'род,ед', 'пр,ед', 'им,ед', 'твор,ед', 'вин,ед'}], ['палец', {'им,ед', 'вин,ед'}]]
худым живеши	[['худой', {'дат,мн', 'твор,ед'}], ['живеш', {'вин,мн', 'им,мн'}]]
худы они	[['худой', {'мн,кр'}], ['они', {'им,мн'}]]
худыми пальцами	[['худой', {'твор,мн'}], ['палец', {'твор,мн'}]]
худыми ребрами	[['худой', {'твор,мн'}], ['ребро', {'твор,мн'}]]
худом темном	[['худой', {'пр,ед'}], ['темный', set()]]
худое решето	[['худой', {'им,ед', 'вин,ед'}], ['решето', {'им,ед', 'вин,ед'}]]
худую память	[['худой', {'вин,ед'}], ['память', {'им,ед', 'вин,ед'}]]
худая славушка	[['худой', {'им,ед'}], ['славушка', {'им,ед'}]]
худые успехи	[['худой', {'вин,мн', 'им,мн'}], ['успех', {'вин,мн', 'им,мн'}]]
худой англичанин	[['худой', {'дат,ед', 'род,ед', 'пр,ед', 'им,ед', 'твор,ед', 'вин,ед'}], ['англичанин', {'им,ед'}]]
худые времена	[['худой', {'вин,мн', 'им,мн'}], ['время', {'вин,мн', 'им,мн'}]]
худые бедра	[['худой', {'вин,мн', 'им,мн'}], ['бедро', {'род,ед', 'вин,мн', 'им,мн'}]]
худое житье	[['худой', {'им,ед', 'вин,ед'}], ['житие', {'пр,ед', 'им,ед', 'вин,ед'}]]
худые сообщества	[['худой', {'вин,мн', 'им,мн'}], ['сообщество', {'род,ед', 'вин,мн', 'им,мн'}]]
худом деле	[['худой', {'пр,ед'}], ['дело', {'пр,ед'}]]
худых лаптях	[['худой', {'пр,мн', 'вин,мн', 'род,мн'}], ['лапоть', {'пр,мн'}]]
худой нрав	[['худой', {'дат,ед', 'род,ед', 'пр,ед', 'им,ед', 'твор,ед', 'вин,ед'}], ['нрав', {'им,ед', 'вин,ед'}]]
худое смотрение	[['худой', {'им,ед', 'вин,ед'}], ['смотрение', {'им,ед', 'вин,ед'}]]
худая вода	[['худой', {'им,ед'}], ['вода', {'им,ед'}]]
худ я	[['худой', {'ед,кр'}], ['я', {'им,ед'}]]
худого успеха	[['худой', {'род,ед', 'вин,ед'}], ['успех', {'род,ед'}]]
худыхъ мыслей	[['худой', {'пр,мн', 'вин,мн', 'род,мн'}], ['мысль', {'род,мн'}]]
худого состояния	[['худой', {'род,ед', 'вин,ед'}], ['состояние', {'род,ед', 'вин,мн', 'им,мн'}]]
худой щенок	[['худой', {'дат,ед', 'род,ед', 'пр,ед', 'им,ед', 'твор,ед', 'вин,ед'}], ['щенок', {'им,ед'}]]
худым предзнаменованием	[['худой', {'дат,мн', 'твор,ед'}], ['предзнаменование', {'твор,ед'}]]
худым плечом	[['худой', {'дат,мн', 'твор,ед'}], ['плечо', {'твор,ед'}]]
худой рожи	[['худой', {'дат,ед', 'род,ед', 'пр,ед', 'им,ед', 'твор,ед', 'вин,ед'}], ['рожа', {'род,ед', 'вин,мн', 'им,мн'}]]
худого мальчишку	[['худой', {'род,ед', 'вин,ед'}], ['мальчишка', {'вин,ед'}]]
худой шеей	[['худой', {'дат,ед', 'род,ед', 'пр,ед', 'им,ед', 'твор,ед', 'вин,ед'}], ['шея', {'твор,ед'}]]
худые кулаки	[['худой', {'вин,мн', 'им,мн'}], ['кулак', {'вин,мн', 'им,мн'}]]
худые лошади	[['худой', {'вин,мн', 'им,мн'}], ['лошадь', {'род,ед', 'пр,ед', 'дат,ед', 'им,мн'}]]
худой поступокъ	[['худой', {'дат,ед', 'род,ед', 'пр,ед', 'им,ед', 'твор,ед', 'вин,ед'}], ['поступок', {'им,ед', 'вин,ед'}]]
худом плече	[['худой', {'пр,ед'}], ['плечо', {'пр,ед'}]]
худой блондин	[['худой', {'дат,ед', 'род,ед', 'пр,ед', 'им,ед', 'твор,ед', 'вин,ед'}], ['блондин', {'им,ед'}]]
худой старикъ	[['худой', {'дат,ед', 'род,ед', 'пр,ед', 'им,ед', 'твор,ед', 'вин,ед'}], ['старик', {'им,ед'}]]
худых колен	[['худой', {'пр,мн', 'вин,мн', 'род,мн'}], ['колено', {'род,мн'}]]
худыми ножками	[['худой', {'твор,мн'}], ['ножка', {'твор,мн'}]]
худых ногах	[['худой', {'пр,мн', 'вин,мн', 'род,мн'}], ['нога', {'пр,мн'}]]
худого ведра	[['худой', {'род,ед', 'вин,ед'}], ['ведро', {'род,ед', 'вин,мн', 'им,мн'}]]
худыми словами	[['худой', {'твор,мн'}], ['слово', {'твор,мн'}]]
худые стихотворцы	[['худой', {'вин,мн', 'им,мн'}], ['стихотворец', {'им,мн'}]]
худой старец	[['худой', {'дат,ед', 'род,ед', 'пр,ед', 'им,ед', 'твор,ед', 'вин,ед'}], ['старец', {'им,ед'}]]
худой его	[['худой', {'дат,ед', 'род,ед', 'пр,ед', 'им,ед', 'твор,ед', 'вин,ед'}], ['он', {'род,ед', 'вин,ед'}]]
худая пора	[['худой', {'им,ед'}], ['пора', set()]]
худую надежду	[['худой', {'вин,ед'}], ['надежда', {'вин,ед'}]]
худого мира	[['худой', {'род,ед', 'вин,ед'}], ['мир', {'род,ед'}]]
худой мужчина	[['худой', {'дат,ед', 'род,ед', 'пр,ед', 'им,ед', 'твор,ед', 'вин,ед'}], ['мужчина', {'им,ед'}]]
худого ни	[['худой', {'род,ед', 'вин,ед'}], ['ни', set()]]
худой человек	[['худой', {'дат,ед', 'род,ед', 'пр,ед', 'им,ед', 'твор,ед', 'вин,ед'}], ['человек', {'им,ед', 'вин,мн', 'род,мн'}]]
худым ногам	[['худой', {'дат,мн', 'твор,ед'}], ['нога', {'дат,мн'}]]
худую лошаденку	[['худой', {'вин,ед'}], ['лошаденка', {'вин,ед'}]]
худом расположении	[['худой', {'пр,ед'}], ['расположение', {'пр,ед'}]]
худой оборот	[['худой', {'дат,ед', 'род,ед', 'пр,ед', 'им,ед', 'твор,ед', 'вин,ед'}], ['оборот', {'им,ед', 'вин,ед'}]]
худого примера	[['худой', {'род,ед', 'вин,ед'}], ['пример', {'род,ед'}]]
худых помыслов	[['худой', {'пр,мн', 'вин,мн', 'род,мн'}], ['помысел', {'род,мн'}]]
худого бога	[['худой', {'род,ед', 'вин,ед'}], ['бог', {'род,ед', 'вин,ед'}]]
худую ногу	[['худой', {'вин,ед'}], ['нога', {'вин,ед'}]]
худого пса	[['худой', {'род,ед', 'вин,ед'}], ['пес', {'род,ед', 'вин,ед'}]]
худое расположеше	[['худой', {'им,ед', 'вин,ед'}], ['расположеш', {'пр,ед'}]]
худого тела	[['худой', {'род,ед', 'вин,ед'}], ['тело', {'род,ед', 'вин,мн', 'им,мн'}]]
худое личико	[['худой', {'им,ед', 'вин,ед'}], ['личико', {'им,ед', 'вин,ед'}]]
худых собак	[['худой', {'пр,мн', 'вин,мн', 'род,мн'}], ['собака', {'вин,мн', 'род,мн'}]]
худое все	[['худой', {'им,ед', 'вин,ед'}], ['все', {'вин,мн', 'им,мн'}]]
худого тебе	[['худой', {'род,ед', 'вин,ед'}], ['ты', {'пр,ед', 'дат,ед'}]]
худые слова	[['худой', {'вин,мн', 'им,мн'}], ['слово', {'род,ед', 'вин,мн', 'им,мн'}]]
худое употребление	[['худой', {'им,ед', 'вин,ед'}], ['употребление', {'им,ед', 'вин,ед'}]]
худые одежды	[['худой', {'вин,мн', 'им,мн'}], ['одежда', {'род,ед', 'вин,мн', 'им,мн'}]]
худое устройство	[['худой', {'им,ед', 'вин,ед'}], ['устройство', {'им,ед', 'вин,ед'}]]
худом армяке	[['худой', {'пр,ед'}], ['армяк', {'пр,ед'}]]
худых женщин	[['худой', {'пр,мн', 'вин,мн', 'род,мн'}], ['женщина', {'вин,мн', 'род,мн'}]]
худым помещикам	[['худой', {'дат,мн', 'твор,ед'}], ['помещик', {'дат,мн'}]]
худомъ состоянии	[['худой', {'пр,ед'}], ['состояние', {'пр,ед'}]]
худой помощник	[['худой', {'дат,ед', 'род,ед', 'пр,ед', 'им,ед', 'твор,ед', 'вин,ед'}], ['помощник', {'им,ед'}]]
худыя дороги	[['худой', {'вин,мн', 'им,мн'}], ['дорога', {'род,ед', 'вин,мн', 'им,мн'}]]
худое плечо	[['худой', {'им,ед', 'вин,ед'}], ['плечо', {'им,ед', 'вин,ед'}]]
худые речи	[['худой', {'вин,мн', 'им,мн'}], ['речь', {'род,ед', 'дат,ед', 'пр,ед', 'вин,мн', 'им,мн'}]]
худые употребления	[['худой', {'вин,мн', 'им,мн'}], ['употребление', {'род,ед', 'вин,мн', 'им,мн'}]]
худого содержания	[['худой', {'род,ед', 'вин,ед'}], ['содержание', {'род,ед', 'вин,мн', 'им,мн'}]]
худой избенке	[['худой', {'дат,ед', 'род,ед', 'пр,ед', 'им,ед', 'твор,ед', 'вин,ед'}], ['избенка', {'пр,ед', 'дат,ед'}]]
худую корову	[['худой', {'вин,ед'}], ['корова', {'вин,ед'}]]
худой вестью	[['худой', {'дат,ед', 'род,ед', 'пр,ед', 'им,ед', 'твор,ед', 'вин,ед'}], ['весть', {'твор,ед'}]]
худые лапти	[['худой', {'вин,мн', 'им,мн'}], ['лапоть', {'вин,мн', 'им,мн'}]]
худую пищу	[['худой', {'вин,ед'}], ['пища', {'вин,ед'}]]
худой крестьянин	[['худой', {'дат,ед', 'род,ед', 'пр,ед', 'им,ед', 'твор,ед', 'вин,ед'}], ['крестьянин', {'им,ед'}]]
худую шею	[['худой', {'вин,ед'}], ['шея', {'вин,ед'}]]
худой квас	[['худой', {'дат,ед', 'род,ед', 'пр,ед', 'им,ед', 'твор,ед', 'вин,ед'}], ['квас', {'им,ед', 'вин,ед'}]]
худая корова	[['худой', {'им,ед'}], ['корова', {'им,ед'}]]
худую погоду	[['худой', {'вин,ед'}], ['погода', {'вин,ед'}]]
худые члены	[['худой', {'вин,мн', 'им,мн'}], ['член', {'им,мн'}]]
худого настроения	[['худой', {'род,ед', 'вин,ед'}], ['настроение', {'род,ед', 'вин,мн', 'им,мн'}]]
худых ее	[['худой', {'пр,мн', 'вин,мн', 'род,мн'}], ['она', {'род,ед', 'вин,ед'}]]
худой писатель	[['худой', {'дат,ед', 'род,ед', 'пр,ед', 'им,ед', 'твор,ед', 'вин,ед'}], ['писатель', {'им,ед'}]]
худая варежка	[['худой', {'им,ед'}], ['варежка', {'им,ед'}]]
худую голову	[['худой', {'вин,ед'}], ['голова', {'вин,ед'}]]
худыми пальчиками	[['худой', {'твор,мн'}], ['пальчик', {'твор,мн'}]]
худая его	[['худой', {'им,ед'}], ['он', {'род,ед', 'вин,ед'}]]
худым рукам	[['худой', {'дат,мн', 'твор,ед'}], ['рука', {'дат,мн'}]]
худой мальчишка	[['худой', {'дат,ед', 'род,ед', 'пр,ед', 'им,ед', 'твор,ед', 'вин,ед'}], ['мальчишка', {'им,ед'}]]
худой стороны	[['худой', {'дат,ед', 'род,ед', 'пр,ед', 'им,ед', 'твор,ед', 'вин,ед'}], ['сторона', {'род,ед', 'вин,мн', 'им,мн'}]]
худые кошки	[['худой', {'вин,мн', 'им,мн'}], ['кошка', {'род,ед', 'им,мн'}]]
худы те	[['худой', {'мн,кр'}], ['тот', set()]]
худых рукавицах	[['худой', {'пр,мн', 'вин,мн', 'род,мн'}], ['рукавица', {'пр,мн'}]]
худого въ	[['худой', {'род,ед', 'вин,ед'}], ['в', set()]]
худом личике	[['худой', {'пр,ед'}], ['личико', {'пр,ед'}]]
худой мысли	[['худой', {'дат,ед', 'род,ед', 'пр,ед', 'им,ед', 'твор,ед', 'вин,ед'}], ['мысль', {'род,ед', 'дат,ед', 'пр,ед', 'вин,мн', 'им,мн'}]]
худым голосом	[['худой', {'дат,мн', 'твор,ед'}], ['голос', {'твор,ед'}]]
худыми куплями	[['худой', {'твор,мн'}], ['купля', {'твор,мн'}]]
худого ребенка	[['худой', {'род,ед', 'вин,ед'}], ['ребенок', {'род,ед', 'вин,ед'}]]
худом виде	[['худой', {'пр,ед'}], ['вид', {'пр,ед'}]]
худых слов	[['худой', {'пр,мн', 'вин,мн', 'род,мн'}], ['слово', {'род,мн'}]]
худой генерал	[['худой', {'дат,ед', 'род,ед', 'пр,ед', 'им,ед', 'твор,ед', 'вин,ед'}], ['генерал', {'им,ед'}]]
худому примеру	[['худой', {'дат,ед'}], ['пример', {'дат,ед'}]]
худого рода	[['худой', {'род,ед', 'вин,ед'}], ['род', {'род,ед', 'вин,мн', 'им,мн'}]]
худому артиллерийскому	[['худой', {'дат,ед'}], ['артиллерийский', set()]]
худых кляч	[['худой', {'пр,мн', 'вин,мн', 'род,мн'}], ['кляча', {'вин,мн', 'род,мн'}]]
худая шейка	[['худой', {'им,ед'}], ['шейка', {'им,ед'}]]
худому лицу	[['худой', {'дат,ед'}], ['лицо', {'дат,ед'}]]
худые приметы	[['худой', {'вин,мн', 'им,мн'}], ['примета', {'род,ед', 'вин,мн', 'им,мн'}]]
худом помещении	[['худой', {'пр,ед'}], ['помещение', {'пр,ед'}]]
худой парень	[['худой', {'дат,ед', 'род,ед', 'пр,ед', 'им,ед', 'твор,ед', 'вин,ед'}], ['парень', {'им,ед'}]]
худых местах	[['худой', {'пр,мн', 'вин,мн', 'род,мн'}], ['место', {'пр,мн'}]]
худой учитель	[['худой', {'дат,ед', 'род,ед', 'пр,ед', 'им,ед', 'твор,ед', 'вин,ед'}], ['учитель', {'им,ед'}]]
худой женой	[['худой', {'дат,ед', 'род,ед', 'пр,ед', 'им,ед', 'твор,ед', 'вин,ед'}], ['жена', {'твор,ед'}]]
худой успех	[['худой', {'дат,ед', 'род,ед', 'пр,ед', 'им,ед', 'твор,ед', 'вин,ед'}], ['успех', {'им,ед', 'вин,ед'}]]
худые слухи	[['худой', {'вин,мн', 'им,мн'}], ['слух', {'вин,мн', 'им,мн'}]]
худой жены	[['худой', {'дат,ед', 'род,ед', 'пр,ед', 'им,ед', 'твор,ед', 'вин,ед'}], ['жена', {'род,ед', 'им,мн'}]]
худые волы	[['худой', {'вин,мн', 'им,мн'}], ['вол', {'им,мн'}]]
худые стороны	[['худой', {'вин,мн', 'им,мн'}], ['сторона', {'род,ед', 'вин,мн', 'им,мн'}]]
худым кулачком	[['худой', {'дат,мн', 'твор,ед'}], ['кулачок', {'твор,ед'}]]
худые девицы	[['худой', {'вин,мн', 'им,мн'}], ['девица', {'род,ед', 'им,мн'}]]
худых делах	[['худой', {'пр,мн', 'вин,мн', 'род,мн'}], ['дело', {'пр,мн'}]]
худое управлеше	[['худой', {'им,ед', 'вин,ед'}], ['управлеша', {'пр,ед', 'дат,ед'}]]
худой майор	[['худой', {'дат,ед', 'род,ед', 'пр,ед', 'им,ед', 'твор,ед', 'вин,ед'}], ['майор', {'им,ед'}]]
худых писцов	[['худой', {'пр,мн', 'вин,мн', 'род,мн'}], ['писец', {'вин,мн', 'род,мн'}]]
худые мужчины	[['худой', {'вин,мн', 'им,мн'}], ['мужчина', {'род,ед', 'им,мн'}]]
худ рук	[['худой', {'ед,кр'}], ['рука', {'род,мн'}]]
худом продолговатом	[['худой', {'пр,ед'}], ['продолговатый', set()]]
худых граждан	[['худой', {'пр,мн', 'вин,мн', 'род,мн'}], ['гражданин', {'вин,мн', 'род,мн'}]]
худых пальцев	[['худой', {'пр,мн', 'вин,мн', 'род,мн'}], ['палец', {'род,мн'}]]
худым подбородком	[['худой', {'дат,мн', 'твор,ед'}], ['подбородок', {'твор,ед'}]]
худой слуга	[['худой', {'дат,ед', 'род,ед', 'пр,ед', 'им,ед', 'твор,ед', 'вин,ед'}], ['слуга', {'им,ед'}]]
худые колени	[['худой', {'вин,мн', 'им,мн'}], ['колено', {'вин,мн', 'им,мн'}]]
худых телах	[['худой', {'пр,мн', 'вин,мн', 'род,мн'}], ['тело', {'пр,мн'}]]
худые пальцы	[['худой', {'вин,мн', 'им,мн'}], ['палец', {'вин,мн', 'им,мн'}]]
худом шлафроке	[['худой', {'пр,ед'}], ['шлафрок', {'пр,ед'}]]
худой проводникъ	[['худой', {'дат,ед', 'род,ед', 'пр,ед', 'им,ед', 'твор,ед', 'вин,ед'}], ['проводник', {'им,ед'}]]
худой молвы	[['худой', {'дат,ед', 'род,ед', 'пр,ед', 'им,ед', 'твор,ед', 'вин,ед'}], ['молва', {'род,ед'}]]
худой птицы	[['худой', {'дат,ед', 'род,ед', 'пр,ед', 'им,ед', 'твор,ед', 'вин,ед'}], ['птица', {'род,ед', 'им,мн'}]]
худое рачение	[['худой', {'им,ед', 'вин,ед'}], ['рачение', {'им,ед', 'вин,ед'}]]
худого отъ	[['худой', {'род,ед', 'вин,ед'}], ['от', set()]]
худого воздуха	[['худой', {'род,ед', 'вин,ед'}], ['воздух', {'род,ед'}]]
худых его	[['худой', {'пр,мн', 'вин,мн', 'род,мн'}], ['он', {'род,ед', 'вин,ед'}]]
худой затылок	[['худой', {'дат,ед', 'род,ед', 'пр,ед', 'им,ед', 'твор,ед', 'вин,ед'}], ['затылок', {'им,ед', 'вин,ед'}]]
худые мысли	[['худой', {'вин,мн', 'им,мн'}], ['мысль', {'род,ед', 'дат,ед', 'пр,ед', 'вин,мн', 'им,мн'}]]
худым успехом	[['худой', {'дат,мн', 'твор,ед'}], ['успех', {'твор,ед'}]]
худой студент	[['худой', {'дат,ед', 'род,ед', 'пр,ед', 'им,ед', 'твор,ед', 'вин,ед'}], ['студент', {'им,ед'}]]
худую фигуру	[['худой', {'вин,ед'}], ['фигура', {'вин,ед'}]]
худые ребра	[['худой', {'вин,мн', 'им,мн'}], ['ребро', {'род,ед', 'вин,мн', 'им,мн'}]]
худую скотину	[['худой', {'вин,ед'}], ['скотина', {'вин,ед'}]]
худыми коленками	[['худой', {'твор,мн'}], ['коленка', {'твор,мн'}]]
худые поступки	[['худой', {'вин,мн', 'им,мн'}], ['поступок', {'вин,мн', 'им,мн'}]]
худыми бедрами	[['худой', {'твор,мн'}], ['бедро', {'твор,мн'}]]
худые замыслы	[['худой', {'вин,мн', 'им,мн'}], ['замысел', {'вин,мн', 'им,мн'}]]
худой гражданин	[['худой', {'дат,ед', 'род,ед', 'пр,ед', 'им,ед', 'твор,ед', 'вин,ед'}], ['гражданин', {'им,ед'}]]
худых следствиях	[['худой', {'пр,мн', 'вин,мн', 'род,мн'}], ['следствие', {'пр,мн'}]]
худых людей	[['худой', {'пр,мн', 'вин,мн', 'род,мн'}], ['человек', {'вин,мн', 'род,мн'}]]
худую сторону	[['худой', {'вин,ед'}], ['сторона', {'вин,ед'}]]
худых ключицах	[['худой', {'пр,мн', 'вин,мн', 'род,мн'}], ['ключица', {'пр,мн'}]]
худых помещиков	[['худой', {'пр,мн', 'вин,мн', 'род,мн'}], ['помещик', {'вин,мн', 'род,мн'}]]
худее меня	[['худой', {'срав'}], ['я', {'род,ед', 'вин,ед'}]]
худым лицом	[['худой', {'дат,мн', 'твор,ед'}], ['лицо', {'твор,ед'}]]
худого расположения	[['худой', {'род,ед', 'вин,ед'}], ['расположение', {'род,ед', 'вин,мн', 'им,мн'}]]
худой муж	[['худой', {'дат,ед', 'род,ед', 'пр,ед', 'им,ед', 'твор,ед', 'вин,ед'}], ['муж', {'им,ед'}]]
худ он	[['худой', {'ед,кр'}], ['он', {'им,ед'}]]
худые плечи	[['худой', {'вин,мн', 'им,мн'}], ['плечо', {'вин,мн', 'им,мн'}]]
худыя плечи	[['худой', {'вин,мн', 'им,мн'}], ['плечо', {'вин,мн', 'им,мн'}]]
худой живописец	[['худой', {'дат,ед', 'род,ед', 'пр,ед', 'им,ед', 'твор,ед', 'вин,ед'}], ['живописец', {'им,ед'}]]
худ руководитель	[['худой', {'ед,кр'}], ['руководитель', {'им,ед'}]]
худому телу	[['худой', {'дат,ед'}], ['тело', {'дат,ед'}]]
худую клячу	[['худой', {'вин,ед'}], ['кляча', {'вин,ед'}]]
худого качества	[['худой', {'род,ед', 'вин,ед'}], ['качество', {'род,ед', 'вин,мн', 'им,мн'}]]
худая Голова	[['худой', {'им,ед'}], ['голова', {'им,ед'}]]
худой парнишка	[['худой', {'дат,ед', 'род,ед', 'пр,ед', 'им,ед', 'твор,ед', 'вин,ед'}], ['парнишка', {'им,ед'}]]
худой товарищ	[['худой', {'дат,ед', 'род,ед', 'пр,ед', 'им,ед', 'твор,ед', 'вин,ед'}], ['товарищ', {'им,ед'}]]
худое направление	[['худой', {'им,ед', 'вин,ед'}], ['направление', {'им,ед', 'вин,ед'}]]
худыми коленями	[['худой', {'твор,мн'}], ['колено', {'твор,мн'}]]
худой след	[['худой', {'дат,ед', 'род,ед', 'пр,ед', 'им,ед', 'твор,ед', 'вин,ед'}], ['след', {'им,ед', 'вин,ед'}]]
худые собаки	[['худой', {'вин,мн', 'им,мн'}], ['собака', {'род,ед', 'им,мн'}]]
худой какъ	[['худой', {'дат,ед', 'род,ед', 'пр,ед', 'им,ед', 'твор,ед', 'вин,ед'}], ['как', set()]]
худых телес	[['худой', {'пр,мн', 'вин,мн', 'род,мн'}], ['телеса', {'род,мн'}]]
худую дорогу	[['худой', {'вин,ед'}], ['дорога', {'вин,ед'}]]
худой миръ	[['худой', {'дат,ед', 'род,ед', 'пр,ед', 'им,ед', 'твор,ед', 'вин,ед'}], ['мир', {'им,ед', 'вин,ед'}]]
худой земле	[['худой', {'дат,ед', 'род,ед', 'пр,ед', 'им,ед', 'твор,ед', 'вин,ед'}], ['земля', {'пр,ед', 'дат,ед'}]]
худая девушка	[['худой', {'им,ед'}], ['девушка', {'им,ед'}]]
худое намерение	[['худой', {'им,ед', 'вин,ед'}], ['намерение', {'им,ед', 'вин,ед'}]]
худом поступке	[['худой', {'пр,ед'}], ['поступок', {'пр,ед'}]]
худое влияние	[['худой', {'им,ед', 'вин,ед'}], ['влияние', {'им,ед', 'вин,ед'}]]
худым бокам	[['худой', {'дат,мн', 'твор,ед'}], ['бок', {'дат,мн'}]]
худые минуты	[['худой', {'вин,мн', 'им,мн'}], ['минута', {'род,ед', 'вин,мн', 'им,мн'}]]
худые сны	[['худой', {'вин,мн', 'им,мн'}], ['сон', {'вин,мн', 'им,мн'}]]
худыми делами	[['худой', {'твор,мн'}], ['дело', {'твор,мн'}]]
худых примеров	[['худой', {'пр,мн', 'вин,мн', 'род,мн'}], ['пример', {'род,мн'}]]
худой оборотъ	[['худой', {'дат,ед', 'род,ед', 'пр,ед', 'им,ед', 'твор,ед', 'вин,ед'}], ['оборот', {'им,ед', 'вин,ед'}]]
худых лопаток	[['худой', {'пр,мн', 'вин,мн', 'род,мн'}], ['лопатка', {'род,мн'}]]
худую собаку	[['худой', {'вин,ед'}], ['собака', {'вин,ед'}]]
худые лопатки	[['худой', {'вин,мн', 'им,мн'}], ['лопатка', {'род,ед', 'вин,мн', 'им,мн'}]]
худой американец	[['худой', {'дат,ед', 'род,ед', 'пр,ед', 'им,ед', 'твор,ед', 'вин,ед'}], ['американец', {'им,ед'}]]
худой брюнет	[['худой', {'дат,ед', 'род,ед', 'пр,ед', 'им,ед', 'твор,ед', 'вин,ед'}], ['брюнет', {'им,ед'}]]
худую минуту	[['худой', {'вин,ед'}], ['минута', {'вин,ед'}]]
худого нам	[['худой', {'род,ед', 'вин,ед'}], ['мы', {'дат,мн'}]]
худую старуху	[['худой', {'вин,ед'}], ['старуха', {'вин,ед'}]]
худая рубашонка	[['худой', {'им,ед'}], ['рубашонка', {'им,ед'}]]
худая собака	[['худой', {'им,ед'}], ['собака', {'им,ед'}]]
худой он	[['худой', {'дат,ед', 'род,ед', 'пр,ед', 'им,ед', 'твор,ед', 'вин,ед'}], ['он', {'им,ед'}]]
худое тельце	[['худой', {'им,ед', 'вин,ед'}], ['тельце', {'пр,ед', 'им,ед', 'вин,ед'}]]
худого конца	[['худой', {'род,ед', 'вин,ед'}], ['конец', {'род,ед'}]]
худые вести	[['худой', {'вин,мн', 'им,мн'}], ['весть', {'род,ед', 'дат,ед', 'пр,ед', 'вин,мн', 'им,мн'}]]
худую нравственность	[['худой', {'вин,ед'}], ['нравственность', {'им,ед', 'вин,ед'}]]
худая память	[['худой', {'им,ед'}], ['память', {'им,ед', 'вин,ед'}]]
худой шинелишке	[['худой', {'дат,ед', 'род,ед', 'пр,ед', 'им,ед', 'твор,ед', 'вин,ед'}], ['шинелишка', {'пр,ед', 'дат,ед'}]]
худых крестьян	[['худой', {'пр,мн', 'вин,мн', 'род,мн'}], ['крестьянин', {'вин,мн', 'род,мн'}]]
худом кафтане	[['худой', {'пр,ед'}], ['кафтан', {'пр,ед'}]]
худом исполнении	[['худой', {'пр,ед'}], ['исполнение', {'пр,ед'}]]
худого их	[['худой', {'род,ед', 'вин,ед'}], ['они', {'вин,мн', 'род,мн'}]]
худ лицом	[['худой', {'ед,кр'}], ['лицо', {'твор,ед'}]]
худая надежда	[['худой', {'им,ед'}], ['надежда', {'им,ед'}]]
худых ботинках	[['худой', {'пр,мн', 'вин,мн', 'род,мн'}], ['ботинок', {'пр,мн'}]]
худые кобели	[['худой', {'вин,мн', 'им,мн'}], ['кобель', {'им,мн'}]]
худого запаха	[['худой', {'род,ед', 'вин,ед'}], ['запах', {'род,ед'}]]
худыми кострецами	[['худой', {'твор,мн'}], ['кострец', {'твор,мн'}]]
худое место	[['худой', {'им,ед', 'вин,ед'}], ['место', {'им,ед', 'вин,ед'}]]
худые ладони	[['худой', {'вин,мн', 'им,мн'}], ['ладонь', {'род,ед', 'дат,ед', 'пр,ед', 'вин,мн', 'им,мн'}]]
худое плечико	[['худой', {'им,ед', 'вин,ед'}], ['плечико', {'им,ед', 'вин,ед'}]]
худая погода	[['худой', {'им,ед'}], ['погода', {'им,ед'}]]
худой воды	[['худой', {'дат,ед', 'род,ед', 'пр,ед', 'им,ед', 'твор,ед', 'вин,ед'}], ['вода', {'род,ед', 'вин,мн', 'им,мн'}]]
худыми проводниками	[['худой', {'твор,мн'}], ['проводник', {'твор,мн'}]]
худого корма	[['худой', {'род,ед', 'вин,ед'}], ['корм', {'род,ед', 'вин,мн', 'им,мн'}]]
худые годы	[['худой', {'вин,мн', 'им,мн'}], ['год', {'вин,мн', 'им,мн'}]]
худая честь	[['худой', {'им,ед'}], ['честь', {'им,ед', 'вин,ед'}]]
худого часа	[['худой', {'род,ед', 'вин,ед'}], ['час', {'род,ед'}]]
худую траву	[['худой', {'вин,ед'}], ['трава', {'вин,ед'}]]
худого сердца	[['худой', {'род,ед', 'вин,ед'}], ['сердце', {'род,ед', 'вин,мн', 'им,мн'}]]
худого мнения	[['худой', {'род,ед', 'вин,ед'}], ['мнение', {'род,ед', 'вин,мн', 'им,мн'}]]
худое предзнаменование	[['худой', {'им,ед', 'вин,ед'}], ['предзнаменование', {'им,ед', 'вин,ед'}]]
худые наклонности	[['худой', {'вин,мн', 'им,мн'}], ['наклонность', {'род,ед', 'дат,ед', 'пр,ед', 'вин,мн', 'им,мн'}]]
худые дни	[['худой', {'вин,мн', 'им,мн'}], ['день', {'вин,мн', 'им,мн'}]]
худыя следствия	[['худой', {'вин,мн', 'им,мн'}], ['следствие', {'род,ед', 'вин,мн', 'им,мн'}]]
худой груди	[['худой', {'дат,ед', 'род,ед', 'пр,ед', 'им,ед', 'твор,ед', 'вин,ед'}], ['грудь', {'род,ед', 'дат,ед', 'пр,ед', 'вин,мн', 'им,мн'}]]
худого мы	[['худой', {'род,ед', 'вин,ед'}], ['мы', {'им,мн'}]]
худая птица	[['худой', {'им,ед'}], ['птица', {'им,ед'}]]
худой погоды	[['худой', {'дат,ед', 'род,ед', 'пр,ед', 'им,ед', 'твор,ед', 'вин,ед'}], ['погода', {'род,ед', 'вин,мн', 'им,мн'}]]
худые стали	[['худой', {'вин,мн', 'им,мн'}], ['становиться', set()]]
худого им	[['худой', {'род,ед', 'вин,ед'}], ['он', {'твор,ед'}]]
худое корыто	[['худой', {'им,ед', 'вин,ед'}], ['корыто', {'им,ед', 'вин,ед'}]]
худые лица	[['худой', {'вин,мн', 'им,мн'}], ['лицо', {'род,ед', 'вин,мн', 'им,мн'}]]
худой лошади	[['худой', {'дат,ед', 'род,ед', 'пр,ед', 'им,ед', 'твор,ед', 'вин,ед'}], ['лошадь', {'род,ед', 'пр,ед', 'дат,ед', 'им,мн'}]]
худая работа	[['худой', {'им,ед'}], ['работа', {'им,ед'}]]
худой жизнью	[['худой', {'дат,ед', 'род,ед', 'пр,ед', 'им,ед', 'твор,ед', 'вин,ед'}], ['жизнь', {'твор,ед'}]]
худого кацапа	[['худой', {'род,ед', 'вин,ед'}], ['кацап', {'род,ед', 'вин,ед'}]]
худой я	[['худой', {'дат,ед', 'род,ед', 'пр,ед', 'им,ед', 'твор,ед', 'вин,ед'}], ['я', {'им,ед'}]]
худую кобылу	[['худой', {'вин,ед'}], ['кобыла', {'вин,ед'}]]
худой жизни	[['худой', {'дат,ед', 'род,ед', 'пр,ед', 'им,ед', 'твор,ед', 'вин,ед'}], ['жизнь', {'род,ед', 'дат,ед', 'пр,ед', 'вин,мн', 'им,мн'}]]
худой примеръ	[['худой', {'дат,ед', 'род,ед', 'пр,ед', 'им,ед', 'твор,ед', 'вин,ед'}], ['пример', {'им,ед', 'вин,ед'}]]
худого мешка	[['худой', {'род,ед', 'вин,ед'}], ['мешок', {'род,ед'}]]
худые женщины	[['худой', {'вин,мн', 'им,мн'}], ['женщина', {'род,ед', 'им,мн'}]]
худой негр	[['худой', {'дат,ед', 'род,ед', 'пр,ед', 'им,ед', 'твор,ед', 'вин,ед'}], ['негр', {'им,ед'}]]
худого умысла	[['худой', {'род,ед', 'вин,ед'}], ['умысел', {'род,ед'}]]
худой одежонке	[['худой', {'дат,ед', 'род,ед', 'пр,ед', 'им,ед', 'твор,ед', 'вин,ед'}], ['одежонка', {'пр,ед', 'дат,ед'}]]
худой конь	[['худой', {'дат,ед', 'род,ед', 'пр,ед', 'им,ед', 'твор,ед', 'вин,ед'}], ['конь', {'им,ед'}]]
худая крыша	[['худой', {'им,ед'}], ['крыша', {'им,ед'}]]
худую щеку	[['худой', {'вин,ед'}], ['щека', {'вин,ед'}]]
худую грудь	[['худой', {'вин,ед'}], ['грудь', {'им,ед', 'вин,ед'}]]
худая трава	[['худой', {'им,ед'}], ['трава', {'им,ед'}]]
худы дела	[['худой', {'мн,кр'}], ['дело', {'род,ед', 'вин,мн', 'им,мн'}]]
худой случай	[['худой', {'дат,ед', 'род,ед', 'пр,ед', 'им,ед', 'твор,ед', 'вин,ед'}], ['случай', {'им,ед', 'вин,ед'}]]
худое платье	[['худой', {'им,ед', 'вин,ед'}], ['платье', {'пр,ед', 'им,ед', 'вин,ед'}]]
худое слово	[['худой', {'им,ед', 'вин,ед'}], ['слово', {'им,ед', 'вин,ед'}]]
худых лаптей	[['худой', {'пр,мн', 'вин,мн', 'род,мн'}], ['лапоть', {'род,мн'}]]
худыми ляжками	[['худой', {'твор,мн'}], ['ляжка', {'твор,мн'}]]
худой старик	[['худой', {'дат,ед', 'род,ед', 'пр,ед', 'им,ед', 'твор,ед', 'вин,ед'}], ['старик', {'им,ед'}]]
худую овцу	[['худой', {'вин,ед'}], ['овца', {'вин,ед'}]]
худом воспитании	[['худой', {'пр,ед'}], ['воспитание', {'пр,ед'}]]
худого намека	[['худой', {'род,ед', 'вин,ед'}], ['намек', {'род,ед'}]]
худой товаръ	[['худой', {'дат,ед', 'род,ед', 'пр,ед', 'им,ед', 'твор,ед', 'вин,ед'}], ['товар', {'им,ед', 'вин,ед'}]]
худого кармана	[['худой', {'род,ед', 'вин,ед'}], ['карман', {'род,ед'}]]
худые ручонки	[['худой', {'вин,мн', 'им,мн'}], ['ручонка', {'род,ед', 'вин,мн', 'им,мн'}]]
худых скулах	[['худой', {'пр,мн', 'вин,мн', 'род,мн'}], ['скула', {'пр,мн'}]]
худомъ состоянш	[['худой', {'пр,ед'}], ['состоянша', {'вин,мн', 'род,мн'}]]
худые ее	[['худой', {'вин,мн', 'им,мн'}], ['она', {'род,ед', 'вин,ед'}]]
худому плечу	[['худой', {'дат,ед'}], ['плечо', {'дат,ед'}]]
худая девица	[['худой', {'им,ед'}], ['девица', {'им,ед'}]]
худые сапоги	[['худой', {'вин,мн', 'им,мн'}], ['сапог', {'вин,мн', 'им,мн'}]]
худым телом	[['худой', {'дат,мн', 'твор,ед'}], ['тело', {'твор,ед'}]]
худой тому	[['худой', {'дат,ед', 'род,ед', 'пр,ед', 'им,ед', 'твор,ед', 'вин,ед'}], ['то', {'дат,ед'}]]
худых коров	[['худой', {'пр,мн', 'вин,мн', 'род,мн'}], ['корова', {'вин,мн', 'род,мн'}]]
худом зипуне	[['худой', {'пр,ед'}], ['зипун', {'пр,ед'}]]
худой сапог	[['худой', {'дат,ед', 'род,ед', 'пр,ед', 'им,ед', 'твор,ед', 'вин,ед'}], ['сапог', {'род,мн', 'вин,ед', 'им,ед'}]]
худых случаев	[['худой', {'пр,мн', 'вин,мн', 'род,мн'}], ['случай', {'род,мн'}]]
худое имя	[['худой', {'им,ед', 'вин,ед'}], ['имя', {'им,ед', 'вин,ед'}]]
худых мужчин	[['худой', {'пр,мн', 'вин,мн', 'род,мн'}], ['мужчина', {'вин,мн', 'род,мн'}]]
худой головы	[['худой', {'дат,ед', 'род,ед', 'пр,ед', 'им,ед', 'твор,ед', 'вин,ед'}], ['голова', {'род,ед', 'вин,мн', 'им,мн'}]]
худая кобыла	[['худой', {'им,ед'}], ['кобыла', {'им,ед'}]]
худой способ	[['худой', {'дат,ед', 'род,ед', 'пр,ед', 'им,ед', 'твор,ед', 'вин,ед'}], ['способ', {'им,ед', 'вин,ед'}]]
худые ключицы	[['худой', {'вин,мн', 'им,мн'}], ['ключица', {'род,ед', 'вин,мн', 'им,мн'}]]
худой фигуре	[['худой', {'дат,ед', 'род,ед', 'пр,ед', 'им,ед', 'твор,ед', 'вин,ед'}], ['фигура', {'пр,ед', 'дат,ед'}]]
худые шеи	[['худой', {'вин,мн', 'им,мн'}], ['шея', {'род,ед', 'вин,мн', 'им,мн'}]]
худого места	[['худой', {'род,ед', 'вин,ед'}], ['место', {'род,ед', 'вин,мн', 'им,мн'}]]
худом смуглом	[['худой', {'пр,ед'}], ['смуглый', set()]]
худую службу	[['худой', {'вин,ед'}], ['служба', {'вин,ед'}]]
худых щек	[['худой', {'пр,мн', 'вин,мн', 'род,мн'}], ['щека', {'род,мн'}]]
худые кони	[['худой', {'вин,мн', 'им,мн'}], ['конь', {'им,мн'}]]
худые думки	[['худой', {'вин,мн', 'им,мн'}], ['думка', {'род,ед', 'вин,мн', 'им,мн'}]]
худом человеке	[['худой', {'пр,ед'}], ['человек', {'пр,ед'}]]
худому урожаю	[['худой', {'дат,ед'}], ['урожай', {'дат,ед'}]]
худых башмаков	[['худой', {'пр,мн', 'вин,мн', 'род,мн'}], ['башмак', {'род,мн'}]]
худую жизнь	[['худой', {'вин,ед'}], ['жизнь', {'им,ед', 'вин,ед'}]]
худой финдиректор	[['худой', {'дат,ед', 'род,ед', 'пр,ед', 'им,ед', 'твор,ед', 'вин,ед'}], ['финдиректор', {'им,ед'}]]
худых боках	[['худой', {'пр,мн', 'вин,мн', 'род,мн'}], ['бок', {'пр,мн'}]]
худыми ручонками	[['худой', {'твор,мн'}], ['ручонка', {'твор,мн'}]]
худыми плотинами	[['худой', {'твор,мн'}], ['плотина', {'твор,мн'}]]
худого слова	[['худой', {'род,ед', 'вин,ед'}], ['слово', {'род,ед', 'вин,мн', 'им,мн'}]]
худом платье	[['худой', {'пр,ед'}], ['платье', {'пр,ед', 'им,ед', 'вин,ед'}]]
худому парню	[['худой', {'дат,ед'}], ['парень', {'дат,ед'}]]
худого мужчины	[['худой', {'род,ед', 'вин,ед'}], ['мужчина', {'род,ед', 'им,мн'}]]
худые помыслы	[['худой', {'вин,мн', 'им,мн'}], ['помысел', {'вин,мн', 'им,мн'}]]
худой грудью	[['худой', {'дат,ед', 'род,ед', 'пр,ед', 'им,ед', 'твор,ед', 'вин,ед'}], ['грудь', {'твор,ед'}]]
худого никому	[['худой', {'род,ед', 'вин,ед'}], ['никто', {'дат,ед'}]]
худого чего	[['худой', {'род,ед', 'вин,ед'}], ['что', {'род,ед'}]]
худую славу	[['худой', {'вин,ед'}], ['слава', {'вин,ед'}]]
худая избушка	[['худой', {'им,ед'}], ['избушка', {'им,ед'}]]
худые черти	[['худой', {'вин,мн', 'им,мн'}], ['черт', {'им,мн'}]]
худая лошадь	[['худой', {'им,ед'}], ['лошадь', {'им,ед', 'вин,ед'}]]
худую девочку	[['худой', {'вин,ед'}], ['девочка', {'вин,ед'}]]
худые штаны	[['худой', {'вин,мн', 'им,мн'}], ['штаны', {'вин,мн', 'им,мн'}]]
худой разум	[['худой', {'дат,ед', 'род,ед', 'пр,ед', 'им,ед', 'твор,ед', 'вин,ед'}], ['разум', {'им,ед', 'вин,ед'}]]
худого вкуса	[['худой', {'род,ед', 'вин,ед'}], ['вкус', {'род,ед'}]]
худое ее	[['худой', {'им,ед', 'вин,ед'}], ['она', {'род,ед', 'вин,ед'}]]
худой красноармеец	[['худой', {'дат,ед', 'род,ед', 'пр,ед', 'им,ед', 'твор,ед', 'вин,ед'}], ['красноармеец', {'им,ед'}]]
худомъ состояши	[['худой', {'пр,ед'}], ['состояш', {'вин,мн', 'им,мн'}]]
худой господинъ	[['худой', {'дат,ед', 'род,ед', 'пр,ед', 'им,ед', 'твор,ед', 'вин,ед'}], ['господин', {'им,ед'}]]
худому делу	[['худой', {'дат,ед'}], ['дело', {'дат,ед'}]]
худого урожая	[['худой', {'род,ед', 'вин,ед'}], ['урожай', {'род,ед'}]]
худого поведения	[['худой', {'род,ед', 'вин,ед'}], ['поведение', {'род,ед', 'вин,мн', 'им,мн'}]]
худая блондинка	[['худой', {'им,ед'}], ['блондинка', {'им,ед'}]]
худых дел	[['худой', {'пр,мн', 'вин,мн', 'род,мн'}], ['дело', {'род,мн'}]]
худой славе	[['худой', {'дат,ед', 'род,ед', 'пр,ед', 'им,ед', 'твор,ед', 'вин,ед'}], ['слава', {'пр,ед', 'дат,ед'}]]
худомъ лице	[['худой', {'пр,ед'}], ['лицо', {'пр,ед'}]]
худой совет	[['худой', {'дат,ед', 'род,ед', 'пр,ед', 'им,ед', 'твор,ед', 'вин,ед'}], ['совет', {'им,ед', 'вин,ед'}]]
худым ляжкам	[['худой', {'дат,мн', 'твор,ед'}], ['ляжка', {'дат,мн'}]]
худой человечишка	[['худой', {'дат,ед', 'род,ед', 'пр,ед', 'им,ед', 'твор,ед', 'вин,ед'}], ['человечишка', {'им,ед'}]]
худые были	[['худой', {'вин,мн', 'им,мн'}], ['быть', set()]]
худой плод	[['худой', {'дат,ед', 'род,ед', 'пр,ед', 'им,ед', 'твор,ед', 'вин,ед'}], ['плод', {'им,ед', 'вин,ед'}]]
худой спиной	[['худой', {'дат,ед', 'род,ед', 'пр,ед', 'им,ед', 'твор,ед', 'вин,ед'}], ['спина', {'твор,ед'}]]
худого людям	[['худой', {'род,ед', 'вин,ед'}], ['человек', {'дат,мн'}]]
худые людишки	[['худой', {'вин,мн', 'им,мн'}], ['людишки', {'им,мн'}]]
худое отъ	[['худой', {'им,ед', 'вин,ед'}], ['от', set()]]
худым людем	[['худой', {'дат,мн', 'твор,ед'}], ['людем', {'им,ед', 'вин,ед'}]]
худые кисти	[['худой', {'вин,мн', 'им,мн'}], ['кисть', {'род,ед', 'дат,ед', 'пр,ед', 'вин,мн', 'им,мн'}]]
худые соболи	[['худой', {'вин,мн', 'им,мн'}], ['соболь', {'им,мн'}]]
худой перевод	[['худой', {'дат,ед', 'род,ед', 'пр,ед', 'им,ед', 'твор,ед', 'вин,ед'}], ['перевод', {'им,ед', 'вин,ед'}]]
худыя времена	[['худой', {'вин,мн', 'им,мн'}], ['время', {'вин,мн', 'им,мн'}]]
худое время	[['худой', {'им,ед', 'вин,ед'}], ['время', {'им,ед', 'вин,ед'}]]
худые деревья	[['худой', {'вин,мн', 'им,мн'}], ['дерево', {'вин,мн', 'им,мн'}]]
худое ведро	[['худой', {'им,ед', 'вин,ед'}], ['ведро', {'им,ед', 'вин,ед'}]]
худых сапог	[['худой', {'пр,мн', 'вин,мн', 'род,мн'}], ['сапог', {'род,мн', 'вин,ед', 'им,ед'}]]
худого хозяина	[['худой', {'род,ед', 'вин,ед'}], ['хозяин', {'род,ед', 'вин,ед'}]]
худых мужиков	[['худой', {'пр,мн', 'вин,мн', 'род,мн'}], ['мужик', {'вин,мн', 'род,мн'}]]
худыя качества	[['худой', {'вин,мн', 'им,мн'}], ['качество', {'род,ед', 'вин,мн', 'им,мн'}]]
худым миром	[['худой', {'дат,мн', 'твор,ед'}], ['мир', {'твор,ед'}]]
худого плеча	[['худой', {'род,ед', 'вин,ед'}], ['плечо', {'род,ед'}]]
худые навыки	[['худой', {'вин,мн', 'им,мн'}], ['навык', {'вин,мн', 'им,мн'}]]
худыми мыслями	[['худой', {'твор,мн'}], ['мысль', {'твор,мн'}]]
худое дъло	[['худой', {'им,ед', 'вин,ед'}], ['дъло', {'дат,ед', 'пр,ед', 'твор,ед', 'род,мн', 'им,мн', 'род,ед', 'пр,мн', 'твор,мн', 'дат,мн', 'им,ед', 'вин,мн', 'вин,ед'}]]
худой раб	[['худой', {'дат,ед', 'род,ед', 'пр,ед', 'им,ед', 'твор,ед', 'вин,ед'}], ['раб', {'им,ед'}]]
худой лошадке	[['худой', {'дат,ед', 'род,ед', 'пр,ед', 'им,ед', 'твор,ед', 'вин,ед'}], ['лошадка', {'пр,ед', 'дат,ед'}]]
худыми защитниками	[['худой', {'твор,мн'}], ['защитник', {'твор,мн'}]]
худую работу	[['худой', {'вин,ед'}], ['работа', {'вин,ед'}]]
худой нравъ	[['худой', {'дат,ед', 'род,ед', 'пр,ед', 'им,ед', 'твор,ед', 'вин,ед'}], ['нрав', {'им,ед', 'вин,ед'}]]
худая кошка	[['худой', {'им,ед'}], ['кошка', {'им,ед'}]]
худой мастеровой	[['худой', {'дат,ед', 'род,ед', 'пр,ед', 'им,ед', 'твор,ед', 'вин,ед'}], ['мастеровой', {'им,ед'}]]
худых отцов	[['худой', {'пр,мн', 'вин,мн', 'род,мн'}], ['отец', {'вин,мн', 'род,мн'}]]
худого мальчика	[['худой', {'род,ед', 'вин,ед'}], ['мальчик', {'род,ед', 'вин,ед'}]]
худом состоянии	[['худой', {'пр,ед'}], ['состояние', {'пр,ед'}]]
худым пальцем	[['худой', {'дат,мн', 'твор,ед'}], ['палец', {'твор,ед'}]]
худая девочка	[['худой', {'им,ед'}], ['девочка', {'им,ед'}]]
худая женщина	[['худой', {'им,ед'}], ['женщина', {'им,ед'}]]
худой рукой	[['худой', {'дат,ед', 'род,ед', 'пр,ед', 'им,ед', 'твор,ед', 'вин,ед'}], ['рука', {'твор,ед'}]]
худая одежонка	[['худой', {'им,ед'}], ['одежонка', {'им,ед'}]]
худыя стороны	[['худой', {'вин,мн', 'им,мн'}], ['сторона', {'род,ед', 'вин,мн', 'им,мн'}]]
худыми сторонами	[['худой', {'твор,мн'}], ['сторона', {'твор,мн'}]]
худого намерения	[['худой', {'род,ед', 'вин,ед'}], ['намерение', {'род,ед', 'вин,мн', 'им,мн'}]]
худого глаза	[['худой', {'род,ед', 'вин,ед'}], ['глаз', {'род,ед', 'вин,мн', 'им,мн'}]]
худой шеи	[['худой', {'дат,ед', 'род,ед', 'пр,ед', 'им,ед', 'твор,ед', 'вин,ед'}], ['шея', {'род,ед', 'вин,мн', 'им,мн'}]]
худая земля	[['худой', {'им,ед'}], ['земля', {'им,ед'}]]
худом счету	[['худой', {'пр,ед'}], ['счет', {'дат,ед', 'парт,ед'}]]
худых последствий	[['худой', {'пр,мн', 'вин,мн', 'род,мн'}], ['последствие', {'род,мн'}]]
худой дороги	[['худой', {'дат,ед', 'род,ед', 'пр,ед', 'им,ед', 'твор,ед', 'вин,ед'}], ['дорога', {'род,ед', 'вин,мн', 'им,мн'}]]
худыми поступками	[['худой', {'твор,мн'}], ['поступок', {'твор,мн'}]]
худыя щеки	[['худой', {'вин,мн', 'им,мн'}], ['щека', {'род,ед', 'вин,мн', 'им,мн'}]]
худая шея	[['худой', {'им,ед'}], ['шея', {'им,ед'}]]
худого блондина	[['худой', {'род,ед', 'вин,ед'}], ['блондин', {'род,ед', 'вин,ед'}]]
худой поросенок	[['худой', {'дат,ед', 'род,ед', 'пр,ед', 'им,ед', 'твор,ед', 'вин,ед'}], ['поросенок', {'им,ед'}]]
худым примером	[['худой', {'дат,мн', 'твор,ед'}], ['пример', {'твор,ед'}]]
худыми ручками	[['худой', {'твор,мн'}], ['ручка', {'твор,мн'}]]
худых экономиях	[['худой', {'пр,мн', 'вин,мн', 'род,мн'}], ['экономия', {'пр,мн'}]]
худого скелета	[['худой', {'род,ед', 'вин,ед'}], ['скелет', {'род,ед'}]]
худое поведеше	[['худой', {'им,ед', 'вин,ед'}], ['поведеш', {'пр,ед'}]]
худую жену	[['худой', {'вин,ед'}], ['жена', {'вин,ед'}]]
худая нога	[['худой', {'им,ед'}], ['нога', {'им,ед'}]]
худых мыслей	[['худой', {'пр,мн', 'вин,мн', 'род,мн'}], ['мысль', {'род,мн'}]]
худое оно	[['худой', {'им,ед', 'вин,ед'}], ['оно', {'им,ед'}]]
худой целью	[['худой', {'дат,ед', 'род,ед', 'пр,ед', 'им,ед', 'твор,ед', 'вин,ед'}], ['цель', {'твор,ед'}]]
худыми локтями	[['худой', {'твор,мн'}], ['локоть', {'твор,мн'}]]
худые ризы	[['худой', {'вин,мн', 'им,мн'}], ['риза', {'род,ед', 'вин,мн', 'им,мн'}]]
худые армяки	[['худой', {'вин,мн', 'им,мн'}], ['армяк', {'вин,мн', 'им,мн'}]]
худой плетень	[['худой', {'дат,ед', 'род,ед', 'пр,ед', 'им,ед', 'твор,ед', 'вин,ед'}], ['плетень', {'им,ед', 'вин,ед'}]]
худой женщине	[['худой', {'дат,ед', 'род,ед', 'пр,ед', 'им,ед', 'твор,ед', 'вин,ед'}], ['женщина', {'пр,ед', 'дат,ед'}]]
худые писатели	[['худой', {'вин,мн', 'им,мн'}], ['писатель', {'им,мн'}]]
худым забором	[['худой', {'дат,мн', 'твор,ед'}], ['забор', {'твор,ед'}]]
худой дороге	[['худой', {'дат,ед', 'род,ед', 'пр,ед', 'им,ед', 'твор,ед', 'вин,ед'}], ['дорога', {'пр,ед', 'дат,ед'}]]
худой мальчик	[['худой', {'дат,ед', 'род,ед', 'пр,ед', 'им,ед', 'твор,ед', 'вин,ед'}], ['мальчик', {'им,ед'}]]
худом доме	[['худой', {'пр,ед'}], ['дом', {'пр,ед'}]]
худой мужичок	[['худой', {'дат,ед', 'род,ед', 'пр,ед', 'им,ед', 'твор,ед', 'вин,ед'}], ['мужичок', {'им,ед'}]]
худые ручки	[['худой', {'вин,мн', 'им,мн'}], ['ручка', {'род,ед', 'вин,мн', 'им,мн'}]]
худомъ положенш	[['худой', {'пр,ед'}], ['положенша', {'вин,мн', 'род,мн'}]]
худое состояние	[['худой', {'им,ед', 'вин,ед'}], ['состояние', {'им,ед', 'вин,ед'}]]
худой дядька	[['худой', {'дат,ед', 'род,ед', 'пр,ед', 'им,ед', 'твор,ед', 'вин,ед'}], ['дядька', {'им,ед'}]]
худые склонности	[['худой', {'вин,мн', 'им,мн'}], ['склонность', {'род,ед', 'дат,ед', 'пр,ед', 'вин,мн', 'им,мн'}]]
худо дело	[['худой', {'ед,кр'}], ['дело', {'им,ед', 'вин,ед'}]]
худая весть	[['худой', {'им,ед'}], ['весть', {'им,ед', 'вин,ед'}]]
худое окно	[['худой', {'им,ед', 'вин,ед'}], ['окно', {'им,ед', 'вин,ед'}]]
худая тень	[['худой', {'им,ед'}], ['тень', {'им,ед', 'вин,ед'}]]
худой домишко	[['худой', {'дат,ед', 'род,ед', 'пр,ед', 'им,ед', 'твор,ед', 'вин,ед'}], ['домишко', {'им,ед', 'вин,ед'}]]
худой погодой	[['худой', {'дат,ед', 'род,ед', 'пр,ед', 'им,ед', 'твор,ед', 'вин,ед'}], ['погода', {'твор,ед'}]]
худой сбыт	[['худой', {'дат,ед', 'род,ед', 'пр,ед', 'им,ед', 'твор,ед', 'вин,ед'}], ['сбыт', {'им,ед', 'вин,ед'}]]
худым парнем	[['худой', {'дат,мн', 'твор,ед'}], ['парень', {'твор,ед'}]]
худой урожай	[['худой', {'дат,ед', 'род,ед', 'пр,ед', 'им,ед', 'твор,ед', 'вин,ед'}], ['урожай', {'им,ед', 'вин,ед'}]]
худой живот	[['худой', {'дат,ед', 'род,ед', 'пр,ед', 'им,ед', 'твор,ед', 'вин,ед'}], ['живот', {'им,ед', 'вин,ед'}]]
худые дороги	[['худой', {'вин,мн', 'им,мн'}], ['дорога', {'род,ед', 'вин,мн', 'им,мн'}]]
худого его	[['худой', {'род,ед', 'вин,ед'}], ['он', {'род,ед', 'вин,ед'}]]
худые руки	[['худой', {'вин,мн', 'им,мн'}], ['рука', {'род,ед', 'вин,мн', 'им,мн'}]]
худой прием	[['худой', {'дат,ед', 'род,ед', 'пр,ед', 'им,ед', 'твор,ед', 'вин,ед'}], ['прием', {'им,ед', 'вин,ед'}]]
худое хозяйство	[['худой', {'им,ед', 'вин,ед'}], ['хозяйство', {'им,ед', 'вин,ед'}]]
худой крышей	[['худой', {'дат,ед', 'род,ед', 'пр,ед', 'им,ед', 'твор,ед', 'вин,ед'}], ['крыша', {'твор,ед'}]]
худых карманов	[['худой', {'пр,мн', 'вин,мн', 'род,мн'}], ['карман', {'род,мн'}]]
худое содержаше	[['худой', {'им,ед', 'вин,ед'}], ['содержаше', {'дат,ед', 'пр,ед', 'твор,ед', 'род,мн', 'им,мн', 'род,ед', 'пр,мн', 'твор,мн', 'дат,мн', 'им,ед', 'вин,мн', 'вин,ед'}]]
худые икры	[['худой', {'вин,мн', 'им,мн'}], ['икра', {'род,ед', 'вин,мн', 'им,мн'}]]
худ телом	[['худой', {'ед,кр'}], ['тело', {'твор,ед'}]]
худого вам	[['худой', {'род,ед', 'вин,ед'}], ['вы', {'дат,мн'}]]
худыми людьми	[['худой', {'твор,мн'}], ['человек', {'твор,мн'}]]
худому разуму	[['худой', {'дат,ед'}], ['разум', {'дат,ед'}]]
худыя последствия	[['худой', {'вин,мн', 'им,мн'}], ['последствие', {'род,ед', 'вин,мн', 'им,мн'}]]
худое что	[['худой', {'им,ед', 'вин,ед'}], ['что', {'им,ед', 'вин,ед'}]]
худого живота	[['худой', {'род,ед', 'вин,ед'}], ['живот', {'род,ед'}]]
худому старику	[['худой', {'дат,ед'}], ['старик', {'дат,ед'}]]
худы товары	[['худой', {'мн,кр'}], ['товар', {'вин,мн', 'им,мн'}]]
худая череда	[['худой', {'им,ед'}], ['череда', {'им,ед'}]]
худые фигуры	[['худой', {'вин,мн', 'им,мн'}], ['фигура', {'род,ед', 'вин,мн', 'им,мн'}]]
худое его	[['худой', {'им,ед', 'вин,ед'}], ['его', set()]]
худой сын	[['худой', {'дат,ед', 'род,ед', 'пр,ед', 'им,ед', 'твор,ед', 'вин,ед'}], ['сын', {'им,ед'}]]
худую одежду	[['худой', {'вин,ед'}], ['одежда', {'вин,ед'}]]
худыя ноги	[['худой', {'вин,мн', 'им,мн'}], ['нога', {'род,ед', 'вин,мн', 'им,мн'}]]
худым щекам	[['худой', {'дат,мн', 'твор,ед'}], ['щека', {'дат,мн'}]]
худой сон	[['худой', {'дат,ед', 'род,ед', 'пр,ед', 'им,ед', 'твор,ед', 'вин,ед'}], ['сон', {'им,ед', 'вин,ед'}]]
худой аттестации	[['худой', {'дат,ед', 'род,ед', 'пр,ед', 'им,ед', 'твор,ед', 'вин,ед'}], ['аттестация', {'род,ед', 'дат,ед', 'пр,ед', 'вин,мн', 'им,мн'}]]
худые шутки	[['худой', {'вин,мн', 'им,мн'}], ['шутка', {'род,ед', 'вин,мн', 'им,мн'}]]
худых обстоятельствах	[['худой', {'пр,мн', 'вин,мн', 'род,мн'}], ['обстоятельство', {'пр,мн'}]]
худая рукавица	[['худой', {'им,ед'}], ['рукавица', {'им,ед'}]]
худою славою	[['худой', {'твор,ед'}], ['слава', {'твор,ед'}]]
худом положении	[['худой', {'пр,ед'}], ['положение', {'пр,ед'}]]
худой бабы	[['худой', {'дат,ед', 'род,ед', 'пр,ед', 'им,ед', 'твор,ед', 'вин,ед'}], ['баба', {'род,ед', 'им,мн'}]]
худая скотина	[['худой', {'им,ед'}], ['скотина', {'им,ед'}]]
худого вы	[['худой', {'род,ед', 'вин,ед'}], ['вы', {'им,мн'}]]
худых лицах	[['худой', {'пр,мн', 'вин,мн', 'род,мн'}], ['лицо', {'пр,мн'}]]
худой шее	[['худой', {'дат,ед', 'род,ед', 'пр,ед', 'им,ед', 'твор,ед', 'вин,ед'}], ['шея', {'пр,ед', 'дат,ед'}]]
худое въ	[['худой', {'им,ед', 'вин,ед'}], ['в', set()]]
худыя слова	[['худой', {'вин,мн', 'им,мн'}], ['слово', {'род,ед', 'вин,мн', 'им,мн'}]]
худую шубенку	[['худой', {'вин,ед'}], ['шубенка', {'вин,ед'}]]
худая дорога	[['худой', {'им,ед'}], ['дорога', {'им,ед'}]]
худая коза	[['худой', {'им,ед'}], ['коза', {'им,ед'}]]
худыхъ последствий	[['худой', {'пр,мн', 'вин,мн', 'род,мн'}], ['последствие', {'род,мн'}]]
худые соки	[['худой', {'вин,мн', 'им,мн'}], ['сок', {'вин,мн', 'им,мн'}]]
худой бой	[['худой', {'дат,ед', 'род,ед', 'пр,ед', 'им,ед', 'твор,ед', 'вин,ед'}], ['бой', {'им,ед', 'вин,ед'}]]
худой путь	[['худой', {'дат,ед', 'род,ед', 'пр,ед', 'им,ед', 'твор,ед', 'вин,ед'}], ['путь', {'им,ед', 'вин,ед'}]]
худ ты	[['худой', {'ед,кр'}], ['ты', {'им,ед'}]]
худой земли	[['худой', {'дат,ед', 'род,ед', 'пр,ед', 'им,ед', 'твор,ед', 'вин,ед'}], ['земля', {'род,ед', 'вин,мн', 'им,мн'}]]
худого товару	[['худой', {'род,ед', 'вин,ед'}], ['товар', {'дат,ед', 'парт,ед'}]]
худой сосед	[['худой', {'дат,ед', 'род,ед', 'пр,ед', 'им,ед', 'твор,ед', 'вин,ед'}], ['сосед', {'им,ед'}]]
худое то	[['худой', {'им,ед', 'вин,ед'}], ['то', set()]]
худых навыков	[['худой', {'пр,мн', 'вин,мн', 'род,мн'}], ['навык', {'род,мн'}]]
худое двло	[['худой', {'им,ед', 'вин,ед'}], ['двло', {'дат,ед', 'пр,ед', 'твор,ед', 'род,мн', 'им,мн', 'род,ед', 'пр,мн', 'твор,мн', 'дат,мн', 'им,ед', 'вин,мн', 'вин,ед'}]]
худого я	[['худой', {'род,ед', 'вин,ед'}], ['я', {'им,ед'}]]
худым примерам	[['худой', {'дат,мн', 'твор,ед'}], ['пример', {'дат,мн'}]]
худую молву	[['худой', {'вин,ед'}], ['молва', {'вин,ед'}]]
худого житья	[['худой', {'род,ед', 'вин,ед'}], ['житие', {'род,ед', 'вин,мн', 'им,мн'}]]
худую плотину	[['худой', {'вин,ед'}], ['плотина', {'вин,ед'}]]
худою славой	[['худой', {'твор,ед'}], ['слава', {'твор,ед'}]]
худыми вестями	[['худой', {'твор,мн'}], ['весть', {'твор,мн'}]]
худой епитрахили	[['худой', {'дат,ед', 'род,ед', 'пр,ед', 'им,ед', 'твор,ед', 'вин,ед'}], ['епитрахиль', {'род,ед', 'дат,ед', 'пр,ед', 'вин,мн', 'им,мн'}]]
худой это	[['худой', {'дат,ед', 'род,ед', 'пр,ед', 'им,ед', 'твор,ед', 'вин,ед'}], ['это', {'им,ед', 'вин,ед'}]]
худых писателей	[['худой', {'пр,мн', 'вин,мн', 'род,мн'}], ['писатель', {'вин,мн', 'род,мн'}]]
худые примеры	[['худой', {'вин,мн', 'им,мн'}], ['пример', {'вин,мн', 'им,мн'}]]
худое это	[['худой', {'им,ед', 'вин,ед'}], ['этот', set()]]
худой овцы	[['худой', {'дат,ед', 'род,ед', 'пр,ед', 'им,ед', 'твор,ед', 'вин,ед'}], ['овца', {'род,ед', 'им,мн'}]]
худого воспитания	[['худой', {'род,ед', 'вин,ед'}], ['воспитание', {'род,ед', 'вин,мн', 'им,мн'}]]
худых вестей	[['худой', {'пр,мн', 'вин,мн', 'род,мн'}], ['весть', {'род,мн'}]]
худых пальто	[['худой', {'пр,мн', 'вин,мн', 'род,мн'}], ['пальто', {'дат,ед', 'пр,ед', 'твор,ед', 'род,мн', 'им,мн', 'род,ед', 'пр,мн', 'твор,мн', 'дат,мн', 'им,ед', 'вин,мн', 'вин,ед'}]]
худые ведра	[['худой', {'вин,мн', 'им,мн'}], ['ведро', {'род,ед', 'вин,мн', 'им,мн'}]]
худой спины	[['худой', {'дат,ед', 'род,ед', 'пр,ед', 'им,ед', 'твор,ед', 'вин,ед'}], ['спина', {'род,ед', 'вин,мн', 'им,мн'}]]
худой нравственности	[['худой', {'дат,ед', 'род,ед', 'пр,ед', 'им,ед', 'твор,ед', 'вин,ед'}], ['нравственность', {'род,ед', 'дат,ед', 'пр,ед', 'вин,мн', 'им,мн'}]]
худых коленях	[['худой', {'пр,мн', 'вин,мн', 'род,мн'}], ['колено', {'пр,мн'}]]
худых лошаденках	[['худой', {'пр,мн', 'вин,мн', 'род,мн'}], ['лошаденка', {'пр,мн'}]]
худых рифмотворцах	[['худой', {'пр,мн', 'вин,мн', 'род,мн'}], ['рифмотворец', {'пр,мн'}]]
худой поручик	[['худой', {'дат,ед', 'род,ед', 'пр,ед', 'им,ед', 'твор,ед', 'вин,ед'}], ['поручик', {'им,ед'}]]
худой нос	[['худой', {'дат,ед', 'род,ед', 'пр,ед', 'им,ед', 'твор,ед', 'вин,ед'}], ['нос', {'им,ед', 'вин,ед'}]]
худая примета	[['худой', {'им,ед'}], ['примета', {'им,ед'}]]
худые бока	[['худой', {'вин,мн', 'им,мн'}], ['бок', {'род,ед', 'вин,мн', 'им,мн'}]]
худых рук	[['худой', {'пр,мн', 'вин,мн', 'род,мн'}], ['рука', {'род,мн'}]]
худым мастерством	[['худой', {'дат,мн', 'твор,ед'}], ['мастерство', {'твор,ед'}]]
худым мужем	[['худой', {'дат,мн', 'твор,ед'}], ['муж', {'твор,ед'}]]
худая жизнь	[['худой', {'им,ед'}], ['жизнь', {'им,ед', 'вин,ед'}]]
худой человечек	[['худой', {'дат,ед', 'род,ед', 'пр,ед', 'им,ед', 'твор,ед', 'вин,ед'}], ['человечек', {'им,ед'}]]
худых поступков	[['худой', {'пр,мн', 'вин,мн', 'род,мн'}], ['поступок', {'род,мн'}]]
худые голени	[['худой', {'вин,мн', 'им,мн'}], ['голень', {'род,ед', 'дат,ед', 'пр,ед', 'вин,мн', 'им,мн'}]]
худое тело	[['худой', {'им,ед', 'вин,ед'}], ['тело', {'им,ед', 'вин,ед'}]]
худым словом	[['худой', {'дат,мн', 'твор,ед'}], ['слово', {'твор,ед'}]]
худым плечам	[['худой', {'дат,мн', 'твор,ед'}], ['плечо', {'дат,мн'}]]
худыми средствами	[['худой', {'твор,мн'}], ['средство', {'твор,мн'}]]
худая спина	[['худой', {'им,ед'}], ['спина', {'им,ед'}]]
худые коленки	[['худой', {'вин,мн', 'им,мн'}], ['коленка', {'род,ед', 'вин,мн', 'им,мн'}]]
худом случае	[['худой', {'пр,ед'}], ['случай', {'пр,ед'}]]
худую кровлю	[['худой', {'вин,ед'}], ['кровля', {'вин,ед'}]]
худое мы	[['худой', {'им,ед', 'вин,ед'}], ['мы', {'им,мн'}]]
худого пастуха	[['худой', {'род,ед', 'вин,ед'}], ['пастух', {'род,ед', 'вин,ед'}]]
худой лицом	[['худой', {'дат,ед', 'род,ед', 'пр,ед', 'им,ед', 'твор,ед', 'вин,ед'}], ['лицо', {'твор,ед'}]]
худое качество	[['худой', {'им,ед', 'вин,ед'}], ['качество', {'им,ед', 'вин,ед'}]]
худой кляче	[['худой', {'дат,ед', 'род,ед', 'пр,ед', 'им,ед', 'твор,ед', 'вин,ед'}], ['кляча', {'пр,ед', 'дат,ед'}]]
худое предзнаменоваше	[['худой', {'им,ед', 'вин,ед'}], ['предзнаменоваш', {'пр,ед'}]]
худой внушитель	[['худой', {'дат,ед', 'род,ед', 'пр,ед', 'им,ед', 'твор,ед', 'вин,ед'}], ['внушитель', {'им,ед', 'вин,ед'}]]
худое направлеше	[['худой', {'им,ед', 'вин,ед'}], ['направлеша', {'пр,ед', 'дат,ед'}]]
худое поведение	[['худой', {'им,ед', 'вин,ед'}], ['поведение', {'им,ед', 'вин,ед'}]]
худой п	[['худой', {'дат,ед', 'род,ед', 'пр,ед', 'им,ед', 'твор,ед', 'вин,ед'}], ['п', {'дат,ед', 'пр,ед', 'твор,ед', 'род,мн', 'им,мн', 'род,ед', 'пр,мн', 'твор,мн', 'дат,мн', 'им,ед', 'вин,мн', 'вин,ед'}]]
худую привычку	[['худой', {'вин,ед'}], ['привычка', {'вин,ед'}]]
худого исхода	[['худой', {'род,ед', 'вин,ед'}], ['исход', {'род,ед'}]]
худой глаз	[['худой', {'дат,ед', 'род,ед', 'пр,ед', 'им,ед', 'твор,ед', 'вин,ед'}], ['глаз', {'род,мн', 'вин,ед', 'им,ед'}]]
худых образцов	[['худой', {'пр,мн', 'вин,мн', 'род,мн'}], ['образец', {'род,мн'}]]
худой немец	[['худой', {'дат,ед', 'род,ед', 'пр,ед', 'им,ед', 'твор,ед', 'вин,ед'}], ['немец', {'им,ед'}]]
худое воспиташе	[['худой', {'им,ед', 'вин,ед'}], ['воспиташа', {'пр,ед', 'дат,ед'}]]
худой гардероб	[['худой', {'дат,ед', 'род,ед', 'пр,ед', 'им,ед', 'твор,ед', 'вин,ед'}], ['гардероб', {'им,ед', 'вин,ед'}]]
худой шинели	[['худой', {'дат,ед', 'род,ед', 'пр,ед', 'им,ед', 'твор,ед', 'вин,ед'}], ['шинель', {'род,ед', 'дат,ед', 'пр,ед', 'вин,мн', 'им,мн'}]]
худые следствия	[['худой', {'вин,мн', 'им,мн'}], ['следствие', {'род,ед', 'вин,мн', 'им,мн'}]]
худой лихач	[['худой', {'дат,ед', 'род,ед', 'пр,ед', 'им,ед', 'твор,ед', 'вин,ед'}], ['лихач', {'им,ед'}]]
худую лошадь	[['худой', {'вин,ед'}], ['лошадь', {'им,ед', 'вин,ед'}]]
худых башмаках	[['худой', {'пр,мн', 'вин,мн', 'род,мн'}], ['башмак', {'пр,мн'}]]
худой ладонью	[['худой', {'дат,ед', 'род,ед', 'пр,ед', 'им,ед', 'твор,ед', 'вин,ед'}], ['ладонь', {'твор,ед'}]]
худая одежда	[['худой', {'им,ед'}], ['одежда', {'им,ед'}]]
худую спину	[['худой', {'вин,ед'}], ['спина', {'вин,ед'}]]
худыя наклонности	[['худой', {'вин,мн', 'им,мн'}], ['наклонность', {'род,ед', 'дат,ед', 'пр,ед', 'вин,мн', 'им,мн'}]]
худой кобыле	[['худой', {'дат,ед', 'род,ед', 'пр,ед', 'им,ед', 'твор,ед', 'вин,ед'}], ['кобыла', {'пр,ед', 'дат,ед'}]]
худом его	[['худой', {'пр,ед'}], ['он', {'род,ед', 'вин,ед'}]]
худая слава	[['худой', {'им,ед'}], ['слава', {'им,ед'}]]
худой памяти	[['худой', {'дат,ед', 'род,ед', 'пр,ед', 'им,ед', 'твор,ед', 'вин,ед'}], ['память', {'род,ед', 'дат,ед', 'пр,ед', 'вин,мн', 'им,мн'}]]
худой ветер	[['худой', {'дат,ед', 'род,ед', 'пр,ед', 'им,ед', 'твор,ед', 'вин,ед'}], ['ветер', {'им,ед', 'вин,ед'}]]
худым дорогам	[['худой', {'дат,мн', 'твор,ед'}], ['дорога', {'дат,мн'}]]
худой признак	[['худой', {'дат,ед', 'род,ед', 'пр,ед', 'им,ед', 'твор,ед', 'вин,ед'}], ['признак', {'им,ед', 'вин,ед'}]]
худое положение	[['худой', {'им,ед', 'вин,ед'}], ['положение', {'им,ед', 'вин,ед'}]]
худым лопаткам	[['худой', {'дат,мн', 'твор,ед'}], ['лопатка', {'дат,мн'}]]
худую женщину	[['худой', {'вин,ед'}], ['женщина', {'вин,ед'}]]
худому гроза	[['худой', {'дат,ед'}], ['гроза', {'им,ед'}]]
худой выборъ	[['худой', {'дат,ед', 'род,ед', 'пр,ед', 'им,ед', 'твор,ед', 'вин,ед'}], ['выбор', {'им,ед', 'вин,ед'}]]
худой человекъ	[['худой', {'дат,ед', 'род,ед', 'пр,ед', 'им,ед', 'твор,ед', 'вин,ед'}], ['человек', {'им,ед', 'вин,мн', 'род,мн'}]]
худой голове	[['худой', {'дат,ед', 'род,ед', 'пр,ед', 'им,ед', 'твор,ед', 'вин,ед'}], ['голова', {'пр,ед', 'дат,ед'}]]
худой старичок	[['худой', {'дат,ед', 'род,ед', 'пр,ед', 'им,ед', 'твор,ед', 'вин,ед'}], ['старичок', {'им,ед'}]]
худой мешок	[['худой', {'дат,ед', 'род,ед', 'пр,ед', 'им,ед', 'твор,ед', 'вин,ед'}], ['мешок', {'им,ед', 'вин,ед'}]]
худой юноша	[['худой', {'дат,ед', 'род,ед', 'пр,ед', 'им,ед', 'твор,ед', 'вин,ед'}], ['юноша', {'им,ед'}]]
худые локти	[['худой', {'вин,мн', 'им,мн'}], ['локоть', {'вин,мн', 'им,мн'}]]
худого семени	[['худой', {'род,ед', 'вин,ед'}], ['семя', {'род,ед', 'пр,ед', 'дат,ед'}]]
худом загорелом	[['худой', {'пр,ед'}], ['загорелый', set()]]
худых щеках	[['худой', {'пр,мн', 'вин,мн', 'род,мн'}], ['щека', {'пр,мн'}]]
худой скот	[['худой', {'дат,ед', 'род,ед', 'пр,ед', 'им,ед', 'твор,ед', 'вин,ед'}], ['скот', {'им,ед', 'вин,ед'}]]
худая вещь	[['худой', {'им,ед'}], ['вещь', {'им,ед', 'вин,ед'}]]
худая брюнетка	[['худой', {'им,ед'}], ['брюнетка', {'им,ед'}]]
худыми ладонями	[['худой', {'твор,мн'}], ['ладонь', {'твор,мн'}]]
худое колено	[['худой', {'им,ед', 'вин,ед'}], ['колено', {'им,ед', 'вин,ед'}]]
худую крышу	[['худой', {'вин,ед'}], ['крыша', {'вин,ед'}]]
худого ничего	[['худой', {'род,ед', 'вин,ед'}], ['ничто', {'род,ед'}]]
худой священник	[['худой', {'дат,ед', 'род,ед', 'пр,ед', 'им,ед', 'твор,ед', 'вин,ед'}], ['священник', {'им,ед'}]]
худом урожае	[['худой', {'пр,ед'}], ['урожай', {'пр,ед'}]]
худая она	[['худой', {'им,ед'}], ['она', {'им,ед'}]]
худое он	[['худой', {'им,ед', 'вин,ед'}], ['он', {'им,ед'}]]
худого они	[['худой', {'род,ед', 'вин,ед'}], ['они', {'им,мн'}]]
худая лошаденка	[['худой', {'им,ед'}], ['лошаденка', {'им,ед'}]]
худой покой	[['худой', {'дат,ед', 'род,ед', 'пр,ед', 'им,ед', 'твор,ед', 'вин,ед'}], ['покой', {'им,ед', 'вин,ед'}]]
худые щеки	[['худой', {'вин,мн', 'им,мн'}], ['щека', {'род,ед', 'вин,мн', 'им,мн'}]]
худой тип	[['худой', {'дат,ед', 'род,ед', 'пр,ед', 'им,ед', 'твор,ед', 'вин,ед'}], ['тип', {'им,ед', 'вин,ед'}]]
худая ты	[['худой', {'им,ед'}], ['ты', {'им,ед'}]]
худое пальтишко	[['худой', {'им,ед', 'вин,ед'}], ['пальтишко', {'им,ед', 'вин,ед'}]]
худую ручку	[['худой', {'вин,ед'}], ['ручка', {'вин,ед'}]]
худом пальто	[['худой', {'пр,ед'}], ['пальто', {'дат,ед', 'пр,ед', 'твор,ед', 'род,мн', 'им,мн', 'род,ед', 'пр,мн', 'твор,мн', 'дат,мн', 'им,ед', 'вин,мн', 'вин,ед'}]]
худой день	[['худой', {'дат,ед', 'род,ед', 'пр,ед', 'им,ед', 'твор,ед', 'вин,ед'}], ['день', {'им,ед', 'вин,ед'}]]
худым его	[['худой', {'дат,мн', 'твор,ед'}], ['его', set()]]
худого офицера	[['худой', {'род,ед', 'вин,ед'}], ['офицер', {'род,ед', 'вин,ед'}]]
худой промысел	[['худой', {'дат,ед', 'род,ед', 'пр,ед', 'им,ед', 'твор,ед', 'вин,ед'}], ['промысел', {'им,ед', 'вин,ед'}]]
худые толки	[['худой', {'вин,мн', 'им,мн'}], ['толк', {'вин,мн', 'им,мн'}]]
худой крыши	[['худой', {'дат,ед', 'род,ед', 'пр,ед', 'им,ед', 'твор,ед', 'вин,ед'}], ['крыша', {'род,ед', 'вин,мн', 'им,мн'}]]
худые крыши	[['худой', {'вин,мн', 'им,мн'}], ['крыша', {'род,ед', 'вин,мн', 'им,мн'}]]
худыми лопатками	[['худой', {'твор,мн'}], ['лопатка', {'твор,мн'}]]
худых видом	[['худой', {'пр,мн', 'вин,мн', 'род,мн'}], ['вид', {'твор,ед'}]]
худыя дела	[['худой', {'вин,мн', 'им,мн'}], ['дело', {'род,ед', 'вин,мн', 'им,мн'}]]
худая рука	[['худой', {'им,ед'}], ['рука', {'им,ед'}]]
худых концов	[['худой', {'пр,мн', 'вин,мн', 'род,мн'}], ['конец', {'род,мн'}]]
худые качества	[['худой', {'вин,мн', 'им,мн'}], ['качество', {'род,ед', 'вин,мн', 'им,мн'}]]
худых ризах	[['худой', {'пр,мн', 'вин,мн', 'род,мн'}], ['риза', {'пр,мн'}]]
худой карман	[['худой', {'дат,ед', 'род,ед', 'пр,ед', 'им,ед', 'твор,ед', 'вин,ед'}], ['карман', {'им,ед', 'вин,ед'}]]
худому качеству	[['худой', {'дат,ед'}], ['качество', {'дат,ед'}]]
худым мужчиной	[['худой', {'дат,мн', 'твор,ед'}], ['мужчина', {'твор,ед'}]]
худом сапоге	[['худой', {'пр,ед'}], ['сапог', {'пр,ед'}]]
худую ладонь	[['худой', {'вин,ед'}], ['ладонь', {'им,ед', 'вин,ед'}]]
худое лицо	[['худой', {'им,ед', 'вин,ед'}], ['лицо', {'им,ед', 'вин,ед'}]]
худой зад	[['худой', {'дат,ед', 'род,ед', 'пр,ед', 'им,ед', 'твор,ед', 'вин,ед'}], ['зад', {'им,ед', 'вин,ед'}]]
худого мужа	[['худой', {'род,ед', 'вин,ед'}], ['муж', {'род,ед', 'вин,ед'}]]
худой лошаденке	[['худой', {'дат,ед', 'род,ед', 'пр,ед', 'им,ед', 'твор,ед', 'вин,ед'}], ['лошаденка', {'пр,ед', 'дат,ед'}]]
худым судьям	[['худой', {'дат,мн', 'твор,ед'}], ['судья', {'дат,мн'}]]
худых мужей	[['худой', {'пр,мн', 'вин,мн', 'род,мн'}], ['муж', {'вин,мн', 'род,мн'}]]
худою пищею	[['худой', {'твор,ед'}], ['пища', {'твор,ед'}]]
худой старухи	[['худой', {'дат,ед', 'род,ед', 'пр,ед', 'им,ед', 'твор,ед', 'вин,ед'}], ['старуха', {'род,ед', 'им,мн'}]]
худая старуха	[['худой', {'им,ед'}], ['старуха', {'им,ед'}]]
худое начало	[['худой', {'им,ед', 'вин,ед'}], ['начало', {'им,ед', 'вин,ед'}]]
худой славушки	[['худой', {'дат,ед', 'род,ед', 'пр,ед', 'им,ед', 'твор,ед', 'вин,ед'}], ['славушка', {'род,ед', 'им,мн'}]]
худой щеке	[['худой', {'дат,ед', 'род,ед', 'пр,ед', 'им,ед', 'твор,ед', 'вин,ед'}], ['щека', {'пр,ед', 'дат,ед'}]]
худые мнения	[['худой', {'вин,мн', 'им,мн'}], ['мнение', {'род,ед', 'вин,мн', 'им,мн'}]]
худую наготу	[['худой', {'вин,ед'}], ['нагота', {'вин,ед'}]]
худом лице	[['худой', {'пр,ед'}], ['лицо', {'пр,ед'}]]
худыми сапогами	[['худой', {'твор,мн'}], ['сапог', {'твор,мн'}]]
худой пес	[['худой', {'дат,ед', 'род,ед', 'пр,ед', 'им,ед', 'твор,ед', 'вин,ед'}], ['пес', {'им,ед'}]]
худая бочка	[['худой', {'им,ед'}], ['бочка', {'им,ед'}]]
худым задом	[['худой', {'дат,мн', 'твор,ед'}], ['зад', {'твор,ед'}]]
худым людям	[['худой', {'дат,мн', 'твор,ед'}], ['человек', {'дат,мн'}]]
худом слове	[['худой', {'пр,ед'}], ['слово', {'пр,ед'}]]
худого ворчанья	[['худой', {'род,ед', 'вин,ед'}], ['ворчание', {'род,ед', 'вин,мн', 'им,мн'}]]
худого присмотра	[['худой', {'род,ед', 'вин,ед'}], ['присмотр', {'род,ед'}]]
худым глазом	[['худой', {'дат,мн', 'твор,ед'}], ['глаз', {'твор,ед'}]]
худая фигура	[['худой', {'им,ед'}], ['фигура', {'им,ед'}]]
худою рукой	[['худой', {'твор,ед'}], ['рука', {'твор,ед'}]]
худой телеге	[['худой', {'дат,ед', 'род,ед', 'пр,ед', 'им,ед', 'твор,ед', 'вин,ед'}], ['телега', {'пр,ед', 'дат,ед'}]]
худыми последствиями	[['худой', {'твор,мн'}], ['последствие', {'твор,мн'}]]
худое общество	[['худой', {'им,ед', 'вин,ед'}], ['общество', {'им,ед', 'вин,ед'}]]
худыми руками	[['худой', {'твор,мн'}], ['рука', {'твор,мн'}]]
худое воспитание	[['худой', {'им,ед', 'вин,ед'}], ['воспитание', {'им,ед', 'вин,ед'}]]
худому мужчине	[['худой', {'дат,ед'}], ['мужчина', {'пр,ед', 'дат,ед'}]]
худые места	[['худой', {'вин,мн', 'им,мн'}], ['место', {'род,ед', 'вин,мн', 'им,мн'}]]
худые запястья	[['худой', {'вин,мн', 'им,мн'}], ['запястье', {'род,ед', 'вин,мн', 'им,мн'}]]
худые ботинки	[['худой', {'вин,мн', 'им,мн'}], ['ботинок', {'вин,мн', 'им,мн'}]]
худой спор	[['худой', {'дат,ед', 'род,ед', 'пр,ед', 'им,ед', 'твор,ед', 'вин,ед'}], ['спор', {'им,ед', 'вин,ед'}]]
худой Иван	[['худой', {'дат,ед', 'род,ед', 'пр,ед', 'им,ед', 'твор,ед', 'вин,ед'}], ['иван', {'им,ед'}]]
худых душах	[['худой', {'пр,мн', 'вин,мн', 'род,мн'}], ['душа', {'пр,мн'}]]
худое управление	[['худой', {'им,ед', 'вин,ед'}], ['управление', {'им,ед', 'вин,ед'}]]
худые лошаденки	[['худой', {'вин,мн', 'им,мн'}], ['лошаденка', {'род,ед', 'им,мн'}]]
худым человеком	[['худой', {'дат,мн', 'твор,ед'}], ['человек', {'твор,ед'}]]
худые мосты	[['худой', {'вин,мн', 'им,мн'}], ['мост', {'вин,мн', 'им,мн'}]]
худые его	[['худой', {'вин,мн', 'им,мн'}], ['он', {'род,ед', 'вин,ед'}]]
худому человеку	[['худой', {'дат,ед'}], ['человек', {'дат,ед'}]]
худой руке	[['худой', {'дат,ед', 'род,ед', 'пр,ед', 'им,ед', 'твор,ед', 'вин,ед'}], ['рука', {'пр,ед', 'дат,ед'}]]
худого ему	[['худой', {'род,ед', 'вин,ед'}], ['он', {'дат,ед'}]]
худые вещи	[['худой', {'вин,мн', 'им,мн'}], ['вещь', {'род,ед', 'дат,ед', 'пр,ед', 'вин,мн', 'им,мн'}]]
худым делам	[['худой', {'дат,мн', 'твор,ед'}], ['дело', {'дат,мн'}]]
худых намерениях	[['худой', {'пр,мн', 'вин,мн', 'род,мн'}], ['намерение', {'пр,мн'}]]
худой пищи	[['худой', {'дат,ед', 'род,ед', 'пр,ед', 'им,ед', 'твор,ед', 'вин,ед'}], ['пища', {'род,ед', 'вин,мн', 'им,мн'}]]
худой одежде	[['худой', {'дат,ед', 'род,ед', 'пр,ед', 'им,ед', 'твор,ед', 'вин,ед'}], ['одежда', {'пр,ед', 'дат,ед'}]]
худыя ризы	[['худой', {'вин,мн', 'им,мн'}], ['риза', {'род,ед', 'вин,мн', 'им,мн'}]]
худыхъ людей	[['худой', {'пр,мн', 'вин,мн', 'род,мн'}], ['человек', {'вин,мн', 'род,мн'}]]
худых намерений	[['худой', {'пр,мн', 'вин,мн', 'род,мн'}], ['намерение', {'род,мн'}]]
худой солдат	[['худой', {'дат,ед', 'род,ед', 'пр,ед', 'им,ед', 'твор,ед', 'вин,ед'}], ['солдат', {'им,ед', 'вин,мн', 'род,мн'}]]
худой руки	[['худой', {'дат,ед', 'род,ед', 'пр,ед', 'им,ед', 'твор,ед', 'вин,ед'}], ['рука', {'род,ед', 'вин,мн', 'им,мн'}]]
худые овцы	[['худой', {'вин,мн', 'им,мн'}], ['овца', {'род,ед', 'им,мн'}]]
худой славы	[['худой', {'дат,ед', 'род,ед', 'пр,ед', 'им,ед', 'твор,ед', 'вин,ед'}], ['слава', {'род,ед', 'вин,мн', 'им,мн'}]]
худые спины	[['худой', {'вин,мн', 'им,мн'}], ['спина', {'род,ед', 'вин,мн', 'им,мн'}]]
худых поступках	[['худой', {'пр,мн', 'вин,мн', 'род,мн'}], ['поступок', {'пр,мн'}]]
худая муха	[['худой', {'им,ед'}], ['муха', {'им,ед'}]]
худую пору	[['худой', {'вин,ед'}], ['пора', {'вин,ед'}]]
худой выбор	[['худой', {'дат,ед', 'род,ед', 'пр,ед', 'им,ед', 'твор,ед', 'вин,ед'}], ['выбор', {'им,ед', 'вин,ед'}]]
худая голова	[['худой', {'им,ед'}], ['голова', {'им,ед'}]]
худой почвы	[['худой', {'дат,ед', 'род,ед', 'пр,ед', 'им,ед', 'твор,ед', 'вин,ед'}], ['почва', {'род,ед', 'вин,мн', 'им,мн'}]]
худой н	[['худой', {'дат,ед', 'род,ед', 'пр,ед', 'им,ед', 'твор,ед', 'вин,ед'}], ['н', {'дат,ед', 'пр,ед', 'твор,ед', 'род,мн', 'им,мн', 'род,ед', 'пр,мн', 'твор,мн', 'дат,мн', 'им,ед', 'вин,мн', 'вин,ед'}]]
худых гостей	[['худой', {'пр,мн', 'вин,мн', 'род,мн'}], ['гость', {'вин,мн', 'род,мн'}]]
худой погоде	[['худой', {'дат,ед', 'род,ед', 'пр,ед', 'им,ед', 'твор,ед', 'вин,ед'}], ['погода', {'пр,ед', 'дат,ед'}]]
худой спине	[['худой', {'дат,ед', 'род,ед', 'пр,ед', 'им,ед', 'твор,ед', 'вин,ед'}], ['спина', {'пр,ед', 'дат,ед'}]]
худых лошадей	[['худой', {'пр,мн', 'вин,мн', 'род,мн'}], ['лошадь', {'вин,мн', 'род,мн'}]]
худая сторона	[['худой', {'им,ед'}], ['сторона', {'им,ед'}]]
худого Барабана	[['худой', {'род,ед', 'вин,ед'}], ['барабан', {'род,ед'}]]
худой фигуры	[['худой', {'дат,ед', 'род,ед', 'пр,ед', 'им,ед', 'твор,ед', 'вин,ед'}], ['фигура', {'род,ед', 'вин,мн', 'им,мн'}]]
худая девчонка	[['худой', {'им,ед'}], ['девчонка', {'им,ед'}]]
худыми щеками	[['худой', {'твор,мн'}], ['щека', {'твор,мн'}]]
худое желание	[['худой', {'им,ед', 'вин,ед'}], ['желание', {'им,ед', 'вин,ед'}]]
худой славой	[['худой', {'дат,ед', 'род,ед', 'пр,ед', 'им,ед', 'твор,ед', 'вин,ед'}], ['слава', {'твор,ед'}]]
худой хозяин	[['худой', {'дат,ед', 'род,ед', 'пр,ед', 'им,ед', 'твор,ед', 'вин,ед'}], ['хозяин', {'им,ед'}]]
худыя свойства	[['худой', {'вин,мн', 'им,мн'}], ['свойство', {'род,ед', 'вин,мн', 'им,мн'}]]
худое дело	[['худой', {'им,ед', 'вин,ед'}], ['дело', {'им,ед', 'вин,ед'}]]
худой молве	[['худой', {'дат,ед', 'род,ед', 'пр,ед', 'им,ед', 'твор,ед', 'вин,ед'}], ['молва', {'пр,ед', 'дат,ед'}]]
худой господин	[['худой', {'дат,ед', 'род,ед', 'пр,ед', 'им,ед', 'твор,ед', 'вин,ед'}], ['господин', {'им,ед'}]]
худые плоды	[['худой', {'вин,мн', 'им,мн'}], ['плод', {'вин,мн', 'им,мн'}]]
худого питания	[['худой', {'род,ед', 'вин,ед'}], ['питание', {'род,ед', 'вин,мн', 'им,мн'}]]
худые мужики	[['худой', {'вин,мн', 'им,мн'}], ['мужик', {'им,мн'}]]
