ледяным выражением	[['ледяной', {'дат,мн', 'твор,ед'}], ['выражение', {'твор,ед'}]]
ледяном походе	[['ледяной', {'пр,ед'}], ['поход', {'пр,ед'}]]
ледяной любезностью	[['ледяной', {'твор,ед', 'пр,ед', 'дат,ед', 'им,ед', 'род,ед', 'вин,ед'}], ['любезность', {'твор,ед'}]]
ледяные стрелы	[['ледяной', {'вин,мн', 'им,мн'}], ['стрела', {'вин,мн', 'род,ед', 'им,мн'}]]
ледяные чертоги	[['ледяной', {'вин,мн', 'им,мн'}], ['чертог', {'вин,мн', 'им,мн'}]]
ледяным дорожкам	[['ледяной', {'дат,мн', 'твор,ед'}], ['дорожка', {'дат,мн'}]]
ледяных лучиков	[['ледяной', {'пр,мн', 'род,мн', 'вин,мн'}], ['лучик', {'род,мн'}]]
ледяные куски	[['ледяной', {'вин,мн', 'им,мн'}], ['кусок', {'вин,мн', 'им,мн'}]]
ледяного коня	[['ледяной', {'род,ед', 'вин,ед'}], ['конь', {'род,ед', 'вин,ед'}]]
ледяным обрывом	[['ледяной', {'дат,мн', 'твор,ед'}], ['обрыв', {'твор,ед'}]]
ледяной равниной	[['ледяной', {'твор,ед', 'пр,ед', 'дат,ед', 'им,ед', 'род,ед', 'вин,ед'}], ['равнина', {'твор,ед'}]]
ледяном крае	[['ледяной', {'пр,ед'}], ['край', {'пр,ед'}]]
ледяную гору	[['ледяной', {'вин,ед'}], ['гора', {'вин,ед'}]]
ледяным покрытием	[['ледяной', {'дат,мн', 'твор,ед'}], ['покрытие', {'твор,ед'}]]
ледяные глазки	[['ледяной', {'вин,мн', 'им,мн'}], ['глазок', {'вин,мн', 'им,мн'}]]
ледяной скале	[['ледяной', {'твор,ед', 'пр,ед', 'дат,ед', 'им,ед', 'род,ед', 'вин,ед'}], ['скала', {'дат,ед', 'пр,ед'}]]
ледяной ветер	[['ледяной', {'твор,ед', 'пр,ед', 'дат,ед', 'им,ед', 'род,ед', 'вин,ед'}], ['ветер', {'вин,ед', 'им,ед'}]]
ледяные дворцы	[['ледяной', {'вин,мн', 'им,мн'}], ['дворец', {'вин,мн', 'им,мн'}]]
ледяные ветры	[['ледяной', {'вин,мн', 'им,мн'}], ['ветер', {'вин,мн', 'им,мн'}]]
ледяной влаги	[['ледяной', {'твор,ед', 'пр,ед', 'дат,ед', 'им,ед', 'род,ед', 'вин,ед'}], ['влага', {'вин,мн', 'род,ед', 'им,мн'}]]
ледяных кромок	[['ледяной', {'пр,мн', 'род,мн', 'вин,мн'}], ['кромка', {'род,мн'}]]
ледяных прослоев	[['ледяной', {'пр,мн', 'род,мн', 'вин,мн'}], ['прослой', {'род,мн'}]]
ледяного безразличия	[['ледяной', {'род,ед', 'вин,ед'}], ['безразличие', {'вин,мн', 'род,ед', 'им,мн'}]]
ледяные трещины	[['ледяной', {'вин,мн', 'им,мн'}], ['трещина', {'вин,мн', 'род,ед', 'им,мн'}]]
ледяном зеркале	[['ледяной', {'пр,ед'}], ['зеркало', {'пр,ед'}]]
ледяном царстве	[['ледяной', {'пр,ед'}], ['царство', {'пр,ед'}]]
ледяных шапок	[['ледяной', {'пр,мн', 'род,мн', 'вин,мн'}], ['шапка', {'род,мн'}]]
ледяного спокойствия	[['ледяной', {'род,ед', 'вин,ед'}], ['спокойствие', {'вин,мн', 'род,ед', 'им,мн'}]]
ледяной кор	[['ледяной', {'твор,ед', 'пр,ед', 'дат,ед', 'им,ед', 'род,ед', 'вин,ед'}], ['кор', {'вин,ед', 'им,ед'}]]
ледяным окном	[['ледяной', {'дат,мн', 'твор,ед'}], ['окно', {'твор,ед'}]]
ледяным морем	[['ледяной', {'дат,мн', 'твор,ед'}], ['море', {'твор,ед'}]]
ледяные когти	[['ледяной', {'вин,мн', 'им,мн'}], ['коготь', {'вин,мн', 'им,мн'}]]
ледяной склон	[['ледяной', {'твор,ед', 'пр,ед', 'дат,ед', 'им,ед', 'род,ед', 'вин,ед'}], ['склон', {'вин,ед', 'им,ед'}]]
ледяной гладью	[['ледяной', {'твор,ед', 'пр,ед', 'дат,ед', 'им,ед', 'род,ед', 'вин,ед'}], ['гладь', {'твор,ед'}]]
ледяными буграми	[['ледяной', {'твор,мн'}], ['бугор', {'твор,мн'}]]
ледяная атмосфера	[['ледяной', {'им,ед'}], ['атмосфера', {'им,ед'}]]
ледяного домика	[['ледяной', {'род,ед', 'вин,ед'}], ['домик', {'род,ед'}]]
ледяном континенте	[['ледяной', {'пр,ед'}], ['континент', {'пр,ед'}]]
ледяной вершине	[['ледяной', {'твор,ед', 'пр,ед', 'дат,ед', 'им,ед', 'род,ед', 'вин,ед'}], ['вершина', {'дат,ед', 'пр,ед'}]]
ледяных глазах	[['ледяной', {'пр,мн', 'род,мн', 'вин,мн'}], ['глаз', {'пр,мн'}]]
ледяная жижа	[['ледяной', {'им,ед'}], ['жижа', {'им,ед'}]]
ледяной коре	[['ледяной', {'твор,ед', 'пр,ед', 'дат,ед', 'им,ед', 'род,ед', 'вин,ед'}], ['кора', {'дат,ед', 'пр,ед'}]]
ледяных берегов	[['ледяной', {'пр,мн', 'род,мн', 'вин,мн'}], ['берег', {'род,мн'}]]
ледяную кровать	[['ледяной', {'вин,ед'}], ['кровать', {'вин,ед', 'им,ед'}]]
ледяным припаем	[['ледяной', {'дат,мн', 'твор,ед'}], ['припай', {'твор,ед'}]]
ледяном подвале	[['ледяной', {'пр,ед'}], ['подвал', {'пр,ед'}]]
ледяная мгла	[['ледяной', {'им,ед'}], ['мгла', {'им,ед'}]]
ледяной бане	[['ледяной', {'твор,ед', 'пр,ед', 'дат,ед', 'им,ед', 'род,ед', 'вин,ед'}], ['баня', {'дат,ед', 'пр,ед'}]]
ледяной компресс	[['ледяной', {'твор,ед', 'пр,ед', 'дат,ед', 'им,ед', 'род,ед', 'вин,ед'}], ['компресс', {'вин,ед', 'им,ед'}]]
ледяной смерти	[['ледяной', {'твор,ед', 'пр,ед', 'дат,ед', 'им,ед', 'род,ед', 'вин,ед'}], ['смерть', {'вин,мн', 'дат,ед', 'пр,ед', 'род,ед', 'им,мн'}]]
ледяной кашей	[['ледяной', {'твор,ед', 'пр,ед', 'дат,ед', 'им,ед', 'род,ед', 'вин,ед'}], ['каша', {'твор,ед'}]]
ледяное царство	[['ледяной', {'вин,ед', 'им,ед'}], ['царство', {'вин,ед', 'им,ед'}]]
ледяное ядро	[['ледяной', {'вин,ед', 'им,ед'}], ['ядро', {'вин,ед', 'им,ед'}]]
ледяным панцирем	[['ледяной', {'дат,мн', 'твор,ед'}], ['панцирь', {'твор,ед'}]]
ледяного лица	[['ледяной', {'род,ед', 'вин,ед'}], ['лицо', {'вин,мн', 'род,ед', 'им,мн'}]]
ледяных скульптур	[['ледяной', {'пр,мн', 'род,мн', 'вин,мн'}], ['скульптура', {'род,мн'}]]
ледяной водой	[['ледяной', {'твор,ед', 'пр,ед', 'дат,ед', 'им,ед', 'род,ед', 'вин,ед'}], ['вода', {'твор,ед'}]]
ледяной вершины	[['ледяной', {'твор,ед', 'пр,ед', 'дат,ед', 'им,ед', 'род,ед', 'вин,ед'}], ['вершина', {'вин,мн', 'род,ед', 'им,мн'}]]
ледяные струйки	[['ледяной', {'вин,мн', 'им,мн'}], ['струйка', {'вин,мн', 'род,ед', 'им,мн'}]]
ледяного тороса	[['ледяной', {'род,ед', 'вин,ед'}], ['торос', {'род,ед'}]]
ледяной поверхностью	[['ледяной', {'твор,ед', 'пр,ед', 'дат,ед', 'им,ед', 'род,ед', 'вин,ед'}], ['поверхность', {'твор,ед'}]]
ледяную холодность	[['ледяной', {'вин,ед'}], ['холодность', {'вин,ед', 'им,ед'}]]
ледяными стенками	[['ледяной', {'твор,мн'}], ['стенка', {'твор,мн'}]]
ледяной крупы	[['ледяной', {'твор,ед', 'пр,ед', 'дат,ед', 'им,ед', 'род,ед', 'вин,ед'}], ['крупа', {'вин,мн', 'род,ед', 'им,мн'}]]
ледяное жилье	[['ледяной', {'вин,ед', 'им,ед'}], ['жилье', {'пр,ед', 'вин,ед', 'им,ед'}]]
ледяной простор	[['ледяной', {'твор,ед', 'пр,ед', 'дат,ед', 'им,ед', 'род,ед', 'вин,ед'}], ['простор', {'вин,ед', 'им,ед'}]]
ледяному насту	[['ледяной', {'дат,ед'}], ['наст', {'дат,ед'}]]
ледяными столбами	[['ледяной', {'твор,мн'}], ['столб', {'твор,мн'}]]
ледяных наростах	[['ледяной', {'пр,мн', 'род,мн', 'вин,мн'}], ['нарост', {'пр,мн'}]]
ледяных сталактитов	[['ледяной', {'пр,мн', 'род,мн', 'вин,мн'}], ['сталактит', {'род,мн'}]]
ледяным налетом	[['ледяной', {'дат,мн', 'твор,ед'}], ['налет', {'твор,ед'}]]
ледяной залежи	[['ледяной', {'твор,ед', 'пр,ед', 'дат,ед', 'им,ед', 'род,ед', 'вин,ед'}], ['залежь', {'вин,мн', 'дат,ед', 'пр,ед', 'род,ед', 'им,мн'}]]
ледяном ручье	[['ледяной', {'пр,ед'}], ['ручей', {'пр,ед'}]]
ледяное море	[['ледяной', {'вин,ед', 'им,ед'}], ['море', {'пр,ед', 'вин,ед', 'им,ед'}]]
ледяном холоде	[['ледяной', {'пр,ед'}], ['холод', {'пр,ед'}]]
ледяной венец	[['ледяной', {'твор,ед', 'пр,ед', 'дат,ед', 'им,ед', 'род,ед', 'вин,ед'}], ['венец', {'вин,ед', 'им,ед'}]]
ледяной пропасти	[['ледяной', {'твор,ед', 'пр,ед', 'дат,ед', 'им,ед', 'род,ед', 'вин,ед'}], ['пропасть', {'вин,мн', 'дат,ед', 'пр,ед', 'род,ед', 'им,мн'}]]
ледяная толща	[['ледяной', {'им,ед'}], ['толща', {'им,ед'}]]
ледяными ножами	[['ледяной', {'твор,мн'}], ['нож', {'твор,мн'}]]
ледяного потока	[['ледяной', {'род,ед', 'вин,ед'}], ['поток', {'род,ед'}]]
ледяные равнины	[['ледяной', {'вин,мн', 'им,мн'}], ['равнина', {'вин,мн', 'род,ед', 'им,мн'}]]
ледяной цемент	[['ледяной', {'твор,ед', 'пр,ед', 'дат,ед', 'им,ед', 'род,ед', 'вин,ед'}], ['цемент', {'вин,ед', 'им,ед'}]]
ледяной дорожкой	[['ледяной', {'твор,ед', 'пр,ед', 'дат,ед', 'им,ед', 'род,ед', 'вин,ед'}], ['дорожка', {'твор,ед'}]]
ледяном море	[['ледяной', {'пр,ед'}], ['море', {'пр,ед', 'вин,ед', 'им,ед'}]]
ледяных полей	[['ледяной', {'пр,мн', 'род,мн', 'вин,мн'}], ['поле', {'род,мн'}]]
ледяных шапках	[['ледяной', {'пр,мн', 'род,мн', 'вин,мн'}], ['шапка', {'пр,мн'}]]
ледяную пластину	[['ледяной', {'вин,ед'}], ['пластина', {'вин,ед'}]]
ледяной переправы	[['ледяной', {'твор,ед', 'пр,ед', 'дат,ед', 'им,ед', 'род,ед', 'вин,ед'}], ['переправа', {'вин,мн', 'род,ед', 'им,мн'}]]
ледяного острога	[['ледяной', {'род,ед', 'вин,ед'}], ['острог', {'род,ед'}]]
ледяные свечи	[['ледяной', {'вин,мн', 'им,мн'}], ['свеча', {'вин,мн', 'род,ед', 'им,мн'}]]
ледяная душа	[['ледяной', {'им,ед'}], ['душа', {'им,ед'}]]
ледяное покрывало	[['ледяной', {'вин,ед', 'им,ед'}], ['покрывало', {'вин,ед', 'им,ед'}]]
ледяных валов	[['ледяной', {'пр,мн', 'род,мн', 'вин,мн'}], ['вал', {'род,мн'}]]
ледяной плиты	[['ледяной', {'твор,ед', 'пр,ед', 'дат,ед', 'им,ед', 'род,ед', 'вин,ед'}], ['плита', {'вин,мн', 'род,ед', 'им,мн'}]]
ледяного дома	[['ледяной', {'род,ед', 'вин,ед'}], ['дом', {'вин,мн', 'род,ед', 'им,мн'}]]
ледяной грязи	[['ледяной', {'твор,ед', 'пр,ед', 'дат,ед', 'им,ед', 'род,ед', 'вин,ед'}], ['грязь', {'вин,мн', 'дат,ед', 'пр,ед', 'род,ед', 'им,мн'}]]
ледяной бородой	[['ледяной', {'твор,ед', 'пр,ед', 'дат,ед', 'им,ед', 'род,ед', 'вин,ед'}], ['борода', {'твор,ед'}]]
ледяным просторам	[['ледяной', {'дат,мн', 'твор,ед'}], ['простор', {'дат,мн'}]]
ледяном лагере	[['ледяной', {'пр,ед'}], ['лагерь', {'пр,ед'}]]
ледяных нагромождений	[['ледяной', {'пр,мн', 'род,мн', 'вин,мн'}], ['нагромождение', {'род,мн'}]]
ледяной равнины	[['ледяной', {'твор,ед', 'пр,ед', 'дат,ед', 'им,ед', 'род,ед', 'вин,ед'}], ['равнина', {'вин,мн', 'род,ед', 'им,мн'}]]
ледяным саваном	[['ледяной', {'дат,мн', 'твор,ед'}], ['саван', {'твор,ед'}]]
ледяной зимой	[['ледяной', {'твор,ед', 'пр,ед', 'дат,ед', 'им,ед', 'род,ед', 'вин,ед'}], ['зима', {'твор,ед'}]]
ледяном ветру	[['ледяной', {'пр,ед'}], ['ветер', {'дат,ед', 'местн,ед'}]]
ледяное кружево	[['ледяной', {'вин,ед', 'им,ед'}], ['кружево', {'вин,ед', 'им,ед'}]]
ледяным ступеням	[['ледяной', {'дат,мн', 'твор,ед'}], ['ступень', {'дат,мн'}]]
ледяных объятий	[['ледяной', {'пр,мн', 'род,мн', 'вин,мн'}], ['объятие', {'род,мн'}]]
ледяную Ось	[['ледяной', {'вин,ед'}], ['ось', {'вин,ед', 'им,ед'}]]
ледяные образования	[['ледяной', {'вин,мн', 'им,мн'}], ['образование', {'вин,мн', 'род,ед', 'им,мн'}]]
ледяное сооружение	[['ледяной', {'вин,ед', 'им,ед'}], ['сооружение', {'вин,ед', 'им,ед'}]]
ледяном слое	[['ледяной', {'пр,ед'}], ['слой', {'пр,ед'}]]
ледяными слезами	[['ледяной', {'твор,мн'}], ['слеза', {'твор,мн'}]]
ледяных пластов	[['ледяной', {'пр,мн', 'род,мн', 'вин,мн'}], ['пласт', {'род,мн'}]]
ледяным переправам	[['ледяной', {'дат,мн', 'твор,ед'}], ['переправа', {'дат,мн'}]]
ледяном кольце	[['ледяной', {'пр,ед'}], ['кольцо', {'пр,ед'}]]
ледяных массивах	[['ледяной', {'пр,мн', 'род,мн', 'вин,мн'}], ['массив', {'пр,мн'}]]
ледяную чашу	[['ледяной', {'вин,ед'}], ['чаша', {'вин,ед'}]]
ледяную комнату	[['ледяной', {'вин,ед'}], ['комната', {'вин,ед'}]]
ледяное плато	[['ледяной', {'вин,ед', 'им,ед'}], ['плато', {'род,мн', 'твор,ед', 'вин,мн', 'пр,ед', 'им,мн', 'дат,ед', 'им,ед', 'твор,мн', 'род,ед', 'вин,ед', 'пр,мн', 'дат,мн'}]]
ледяные прослои	[['ледяной', {'вин,мн', 'им,мн'}], ['прослой', {'вин,мн', 'им,мн'}]]
ледяной ключ	[['ледяной', {'твор,ед', 'пр,ед', 'дат,ед', 'им,ед', 'род,ед', 'вин,ед'}], ['ключ', {'вин,ед', 'им,ед'}]]
ледяным панцырем	[['ледяной', {'дат,мн', 'твор,ед'}], ['панцырь', {'твор,ед'}]]
ледяном току	[['ледяной', {'пр,ед'}], ['ток', {'дат,ед', 'парт,ед', 'местн,ед'}]]
ледяной глазури	[['ледяной', {'твор,ед', 'пр,ед', 'дат,ед', 'им,ед', 'род,ед', 'вин,ед'}], ['глазурь', {'вин,мн', 'дат,ед', 'пр,ед', 'род,ед', 'им,мн'}]]
ледяной колпак	[['ледяной', {'твор,ед', 'пр,ед', 'дат,ед', 'им,ед', 'род,ед', 'вин,ед'}], ['колпак', {'вин,ед', 'им,ед'}]]
ледяным душем	[['ледяной', {'дат,мн', 'твор,ед'}], ['душ', {'твор,ед'}]]
ледяных поверхностей	[['ледяной', {'пр,мн', 'род,мн', 'вин,мн'}], ['поверхность', {'род,мн'}]]
ледяной каше	[['ледяной', {'твор,ед', 'пр,ед', 'дат,ед', 'им,ед', 'род,ед', 'вин,ед'}], ['каша', {'дат,ед', 'пр,ед'}]]
ледяной перемычки	[['ледяной', {'твор,ед', 'пр,ед', 'дат,ед', 'им,ед', 'род,ед', 'вин,ед'}], ['перемычка', {'вин,мн', 'род,ед', 'им,мн'}]]
ледяная стена	[['ледяной', {'им,ед'}], ['стена', {'им,ед'}]]
ледяными обрывами	[['ледяной', {'твор,мн'}], ['обрыв', {'твор,мн'}]]
ледяные туманы	[['ледяной', {'вин,мн', 'им,мн'}], ['туман', {'вин,мн', 'им,мн'}]]
ледяная страна	[['ледяной', {'им,ед'}], ['страна', {'им,ед'}]]
ледяные сосульки	[['ледяной', {'вин,мн', 'им,мн'}], ['сосулька', {'вин,мн', 'род,ед', 'им,мн'}]]
ледяной налет	[['ледяной', {'твор,ед', 'пр,ед', 'дат,ед', 'им,ед', 'род,ед', 'вин,ед'}], ['налет', {'вин,ед', 'им,ед'}]]
ледяных иголок	[['ледяной', {'пр,мн', 'род,мн', 'вин,мн'}], ['иголка', {'род,мн'}]]
ледяным салом	[['ледяной', {'дат,мн', 'твор,ед'}], ['сало', {'твор,ед'}]]
ледяном керне	[['ледяной', {'пр,ед'}], ['керн', {'пр,ед'}]]
ледяном океане	[['ледяной', {'пр,ед'}], ['океан', {'пр,ед'}]]
ледяные панцири	[['ледяной', {'вин,мн', 'им,мн'}], ['панцирь', {'вин,мн', 'им,мн'}]]
ледяной дом	[['ледяной', {'твор,ед', 'пр,ед', 'дат,ед', 'им,ед', 'род,ед', 'вин,ед'}], ['дом', {'вин,ед', 'им,ед'}]]
ледяному панцирю	[['ледяной', {'дат,ед'}], ['панцирь', {'дат,ед'}]]
ледяной линзы	[['ледяной', {'твор,ед', 'пр,ед', 'дат,ед', 'им,ед', 'род,ед', 'вин,ед'}], ['линза', {'вин,мн', 'род,ед', 'им,мн'}]]
ледяным скалам	[['ледяной', {'дат,мн', 'твор,ед'}], ['скала', {'дат,мн'}]]
ледяными иголками	[['ледяной', {'твор,мн'}], ['иголка', {'твор,мн'}]]
ледяной могиле	[['ледяной', {'твор,ед', 'пр,ед', 'дат,ед', 'им,ед', 'род,ед', 'вин,ед'}], ['могила', {'дат,ед', 'пр,ед'}]]
ледяных горках	[['ледяной', {'пр,мн', 'род,мн', 'вин,мн'}], ['горки', {'пр,мн'}]]
ледяных гряд	[['ледяной', {'пр,мн', 'род,мн', 'вин,мн'}], ['гряда', {'род,мн'}]]
ледяного перюда	[['ледяной', {'род,ед', 'вин,ед'}], ['перюда', set()]]
ледяные узоры	[['ледяной', {'вин,мн', 'им,мн'}], ['узор', {'вин,мн', 'им,мн'}]]
ледяные перемычки	[['ледяной', {'вин,мн', 'им,мн'}], ['перемычка', {'вин,мн', 'род,ед', 'им,мн'}]]
ледяных жилах	[['ледяной', {'пр,мн', 'род,мн', 'вин,мн'}], ['жила', {'пр,мн'}]]
ледяных квартирах	[['ледяной', {'пр,мн', 'род,мн', 'вин,мн'}], ['квартира', {'пр,мн'}]]
ледяные крылья	[['ледяной', {'вин,мн', 'им,мн'}], ['крыло', {'вин,мн', 'им,мн'}]]
ледяных кирпичей	[['ледяной', {'пр,мн', 'род,мн', 'вин,мн'}], ['кирпич', {'род,мн'}]]
ледяного молока	[['ледяной', {'род,ед', 'вин,ед'}], ['молоко', {'род,ед'}]]
ледяной крест	[['ледяной', {'твор,ед', 'пр,ед', 'дат,ед', 'им,ед', 'род,ед', 'вин,ед'}], ['крест', {'вин,ед', 'им,ед'}]]
ледяных пылинок	[['ледяной', {'пр,мн', 'род,мн', 'вин,мн'}], ['пылинка', {'род,мн'}]]
ледяной канал	[['ледяной', {'твор,ед', 'пр,ед', 'дат,ед', 'им,ед', 'род,ед', 'вин,ед'}], ['канал', {'вин,ед', 'им,ед'}]]
ледяным презрением	[['ледяной', {'дат,мн', 'твор,ед'}], ['презрение', {'твор,ед'}]]
ледяные кочки	[['ледяной', {'вин,мн', 'им,мн'}], ['кочка', {'вин,мн', 'род,ед', 'им,мн'}]]
ледяного блока	[['ледяной', {'род,ед', 'вин,ед'}], ['блок', {'род,ед'}]]
ледяную поверхность	[['ледяной', {'вин,ед'}], ['поверхность', {'вин,ед', 'им,ед'}]]
ледяным материком	[['ледяной', {'дат,мн', 'твор,ед'}], ['материк', {'твор,ед'}]]
ледяную грязь	[['ледяной', {'вин,ед'}], ['грязь', {'вин,ед', 'им,ед'}]]
ледяной север	[['ледяной', {'твор,ед', 'пр,ед', 'дат,ед', 'им,ед', 'род,ед', 'вин,ед'}], ['север', {'вин,ед', 'им,ед'}]]
ледяного барьера	[['ледяной', {'род,ед', 'вин,ед'}], ['барьер', {'род,ед'}]]
ледяное ущелье	[['ледяной', {'вин,ед', 'им,ед'}], ['ущелие', {'пр,ед', 'вин,ед', 'им,ед'}]]
ледяных пещерах	[['ледяной', {'пр,мн', 'род,мн', 'вин,мн'}], ['пещера', {'пр,мн'}]]
ледяных наростов	[['ледяной', {'пр,мн', 'род,мн', 'вин,мн'}], ['нарост', {'род,мн'}]]
ледяное шампанское	[['ледяной', {'вин,ед', 'им,ед'}], ['шампанское', {'вин,ед', 'им,ед'}]]
ледяных водах	[['ледяной', {'пр,мн', 'род,мн', 'вин,мн'}], ['вода', {'пр,мн'}]]
ледяная гладь	[['ледяной', {'им,ед'}], ['гладь', {'вин,ед', 'им,ед'}]]
ледяных сосулек	[['ледяной', {'пр,мн', 'род,мн', 'вин,мн'}], ['сосулька', {'род,мн'}]]
ледяную яму	[['ледяной', {'вин,ед'}], ['яма', {'вин,ед'}]]
ледяная мысль	[['ледяной', {'им,ед'}], ['мысль', {'вин,ед', 'им,ед'}]]
ледяной водичкой	[['ледяной', {'твор,ед', 'пр,ед', 'дат,ед', 'им,ед', 'род,ед', 'вин,ед'}], ['водичка', {'твор,ед'}]]
ледяные просторы	[['ледяной', {'вин,мн', 'им,мн'}], ['простор', {'вин,мн', 'им,мн'}]]
ледяной замок	[['ледяной', {'твор,ед', 'пр,ед', 'дат,ед', 'им,ед', 'род,ед', 'вин,ед'}], ['замок', {'вин,ед', 'им,ед'}]]
ледяной корки	[['ледяной', {'твор,ед', 'пр,ед', 'дат,ед', 'им,ед', 'род,ед', 'вин,ед'}], ['корка', {'вин,мн', 'род,ед', 'им,мн'}]]
ледяных зерен	[['ледяной', {'пр,мн', 'род,мн', 'вин,мн'}], ['зерно', {'род,мн'}]]
ледяной улыбки	[['ледяной', {'твор,ед', 'пр,ед', 'дат,ед', 'им,ед', 'род,ед', 'вин,ед'}], ['улыбка', {'вин,мн', 'род,ед', 'им,мн'}]]
ледяными дождями	[['ледяной', {'твор,мн'}], ['дождь', {'твор,мн'}]]
ледяной осколок	[['ледяной', {'твор,ед', 'пр,ед', 'дат,ед', 'им,ед', 'род,ед', 'вин,ед'}], ['осколок', {'вин,ед', 'им,ед'}]]
ледяной крошки	[['ледяной', {'твор,ед', 'пр,ед', 'дат,ед', 'им,ед', 'род,ед', 'вин,ед'}], ['крошка', {'вин,мн', 'род,ед', 'им,мн'}]]
ледяная полоса	[['ледяной', {'им,ед'}], ['полоса', {'им,ед'}]]
ледяной крупой	[['ледяной', {'твор,ед', 'пр,ед', 'дат,ед', 'им,ед', 'род,ед', 'вин,ед'}], ['крупа', {'твор,ед'}]]
ледяная бритва	[['ледяной', {'им,ед'}], ['бритва', {'им,ед'}]]
ледяных глаз	[['ледяной', {'пр,мн', 'род,мн', 'вин,мн'}], ['глаз', {'род,мн', 'вин,ед', 'им,ед'}]]
ледяных плотин	[['ледяной', {'пр,мн', 'род,мн', 'вин,мн'}], ['плотина', {'род,мн'}]]
ледяным сквозняком	[['ледяной', {'дат,мн', 'твор,ед'}], ['сквозняк', {'твор,ед'}]]
ледяных островов	[['ледяной', {'пр,мн', 'род,мн', 'вин,мн'}], ['остров', {'род,мн'}]]
ледяная корка	[['ледяной', {'им,ед'}], ['корка', {'им,ед'}]]
ледяной континент	[['ледяной', {'твор,ед', 'пр,ед', 'дат,ед', 'им,ед', 'род,ед', 'вин,ед'}], ['континент', {'вин,ед', 'им,ед'}]]
ледяного щита	[['ледяной', {'род,ед', 'вин,ед'}], ['щит', {'род,ед'}]]
ледяным кернам	[['ледяной', {'дат,мн', 'твор,ед'}], ['керн', {'дат,мн'}]]
ледяном гроте	[['ледяной', {'пр,ед'}], ['грот', {'пр,ед'}]]
ледяные закраины	[['ледяной', {'вин,мн', 'им,мн'}], ['закраина', {'вин,мн', 'род,ед', 'им,мн'}]]
ледяной барьер	[['ледяной', {'твор,ед', 'пр,ед', 'дат,ед', 'им,ед', 'род,ед', 'вин,ед'}], ['барьер', {'вин,ед', 'им,ед'}]]
ледяном массиве	[['ледяной', {'пр,ед'}], ['массив', {'пр,ед'}]]
ледяной стихией	[['ледяной', {'твор,ед', 'пр,ед', 'дат,ед', 'им,ед', 'род,ед', 'вин,ед'}], ['стихия', {'твор,ед'}]]
ледяному клину	[['ледяной', {'дат,ед'}], ['клин', {'дат,ед'}]]
ледяных слоев	[['ледяной', {'пр,мн', 'род,мн', 'вин,мн'}], ['слой', {'род,мн'}]]
ледяных обрывах	[['ледяной', {'пр,мн', 'род,мн', 'вин,мн'}], ['обрыв', {'пр,мн'}]]
ледяная купель	[['ледяной', {'им,ед'}], ['купель', {'вин,ед', 'им,ед'}]]
ледяная трасса	[['ледяной', {'им,ед'}], ['трасса', {'им,ед'}]]
ледяной пустыни	[['ледяной', {'твор,ед', 'пр,ед', 'дат,ед', 'им,ед', 'род,ед', 'вин,ед'}], ['пустыня', {'вин,мн', 'род,ед', 'им,мн'}]]
ледяном просторе	[['ледяной', {'пр,ед'}], ['простор', {'пр,ед'}]]
ледяных громад	[['ледяной', {'пр,мн', 'род,мн', 'вин,мн'}], ['громада', {'род,мн'}]]
ледяным ужасом	[['ледяной', {'дат,мн', 'твор,ед'}], ['ужас', {'твор,ед'}]]
ледяных вершин	[['ледяной', {'пр,мн', 'род,мн', 'вин,мн'}], ['вершина', {'род,мн'}]]
ледяной массив	[['ледяной', {'твор,ед', 'пр,ед', 'дат,ед', 'им,ед', 'род,ед', 'вин,ед'}], ['массив', {'вин,ед', 'им,ед'}]]
ледяных горах	[['ледяной', {'пр,мн', 'род,мн', 'вин,мн'}], ['гора', {'пр,мн'}]]
ледяные объятия	[['ледяной', {'вин,мн', 'им,мн'}], ['объятие', {'вин,мн', 'род,ед', 'им,мн'}]]
ледяных корок	[['ледяной', {'пр,мн', 'род,мн', 'вин,мн'}], ['корка', {'род,мн'}]]
ледяного катка	[['ледяной', {'род,ед', 'вин,ед'}], ['каток', {'род,ед'}]]
ледяные припаи	[['ледяной', {'вин,мн', 'им,мн'}], ['припай', {'вин,мн', 'им,мн'}]]
ледяной избушке	[['ледяной', {'твор,ед', 'пр,ед', 'дат,ед', 'им,ед', 'род,ед', 'вин,ед'}], ['избушка', {'дат,ед', 'пр,ед'}]]
ледяной круг	[['ледяной', {'твор,ед', 'пр,ед', 'дат,ед', 'им,ед', 'род,ед', 'вин,ед'}], ['круг', {'вин,ед', 'им,ед'}]]
ледяном домишке	[['ледяной', {'пр,ед'}], ['домишко', {'дат,ед', 'пр,ед'}]]
ледяной мешок	[['ледяной', {'твор,ед', 'пр,ед', 'дат,ед', 'им,ед', 'род,ед', 'вин,ед'}], ['мешок', {'вин,ед', 'им,ед'}]]
ледяного конгломерата	[['ледяной', {'род,ед', 'вин,ед'}], ['конгломерат', {'род,ед'}]]
ледяным коридорам	[['ледяной', {'дат,мн', 'твор,ед'}], ['коридор', {'дат,мн'}]]
ледяных заберегов	[['ледяной', {'пр,мн', 'род,мн', 'вин,мн'}], ['заберег', {'род,мн'}]]
ледяную сосульку	[['ледяной', {'вин,ед'}], ['сосулька', {'вин,ед'}]]
ледяных зародышей	[['ледяной', {'пр,мн', 'род,мн', 'вин,мн'}], ['зародыш', {'род,мн'}]]
ледяные глаза	[['ледяной', {'вин,мн', 'им,мн'}], ['глаз', {'вин,мн', 'род,ед', 'им,мн'}]]
ледяные деревья	[['ледяной', {'вин,мн', 'им,мн'}], ['дерево', {'вин,мн', 'им,мн'}]]
ледяную кашу	[['ледяной', {'вин,ед'}], ['каша', {'вин,ед'}]]
ледяных толщ	[['ледяной', {'пр,мн', 'род,мн', 'вин,мн'}], ['толща', {'род,мн'}]]
ледяному коридору	[['ледяной', {'дат,ед'}], ['коридор', {'дат,ед'}]]
ледяных покровов	[['ледяной', {'пр,мн', 'род,мн', 'вин,мн'}], ['покров', {'род,мн'}]]
ледяные кольца	[['ледяной', {'вин,мн', 'им,мн'}], ['кольцо', {'вин,мн', 'род,ед', 'им,мн'}]]
ледяная поверхность	[['ледяной', {'им,ед'}], ['поверхность', {'вин,ед', 'им,ед'}]]
ледяные прослойки	[['ледяной', {'вин,мн', 'им,мн'}], ['прослойка', {'вин,мн', 'род,ед', 'им,мн'}]]
ледяной росы	[['ледяной', {'твор,ед', 'пр,ед', 'дат,ед', 'им,ед', 'род,ед', 'вин,ед'}], ['роса', {'вин,мн', 'род,ед', 'им,мн'}]]
ледяной ливень	[['ледяной', {'твор,ед', 'пр,ед', 'дат,ед', 'им,ед', 'род,ед', 'вин,ед'}], ['ливень', {'вин,ед', 'им,ед'}]]
ледяные горы	[['ледяной', {'вин,мн', 'им,мн'}], ['гора', {'вин,мн', 'род,ед', 'им,мн'}]]
ледяными клиньями	[['ледяной', {'твор,мн'}], ['клин', {'твор,мн'}]]
ледяные великаны	[['ледяной', {'вин,мн', 'им,мн'}], ['великан', {'им,мн'}]]
ледяную пучину	[['ледяной', {'вин,ед'}], ['пучина', {'вин,ед'}]]
ледяных пластинок	[['ледяной', {'пр,мн', 'род,мн', 'вин,мн'}], ['пластинка', {'род,мн'}]]
ледяными ядрами	[['ледяной', {'твор,мн'}], ['ядро', {'твор,мн'}]]
ледяного массива	[['ледяной', {'род,ед', 'вин,ед'}], ['массив', {'род,ед'}]]
ледяные линзы	[['ледяной', {'вин,мн', 'им,мн'}], ['линза', {'вин,мн', 'род,ед', 'им,мн'}]]
ледяное болото	[['ледяной', {'вин,ед', 'им,ед'}], ['болото', {'вин,ед', 'им,ед'}]]
ледяной обрыв	[['ледяной', {'твор,ед', 'пр,ед', 'дат,ед', 'им,ед', 'род,ед', 'вин,ед'}], ['обрыв', {'вин,ед', 'им,ед'}]]
ледяной равнине	[['ледяной', {'твор,ед', 'пр,ед', 'дат,ед', 'им,ед', 'род,ед', 'вин,ед'}], ['равнина', {'дат,ед', 'пр,ед'}]]
ледяных великанов	[['ледяной', {'пр,мн', 'род,мн', 'вин,мн'}], ['великан', {'род,мн', 'вин,мн'}]]
ледяным пивом	[['ледяной', {'дат,мн', 'твор,ед'}], ['пиво', {'твор,ед'}]]
ледяного вихря	[['ледяной', {'род,ед', 'вин,ед'}], ['вихорь', {'род,ед'}]]
ледяной кромке	[['ледяной', {'твор,ед', 'пр,ед', 'дат,ед', 'им,ед', 'род,ед', 'вин,ед'}], ['кромка', {'дат,ед', 'пр,ед'}]]
ледяного ложа	[['ледяной', {'род,ед', 'вин,ед'}], ['ложе', {'вин,мн', 'род,ед', 'им,мн'}]]
ледяной человек	[['ледяной', {'твор,ед', 'пр,ед', 'дат,ед', 'им,ед', 'род,ед', 'вин,ед'}], ['человек', {'род,мн', 'вин,мн', 'им,ед'}]]
ледяному окну	[['ледяной', {'дат,ед'}], ['окно', {'дат,ед'}]]
ледяные ноги	[['ледяной', {'вин,мн', 'им,мн'}], ['нога', {'вин,мн', 'род,ед', 'им,мн'}]]
ледяными образованиями	[['ледяной', {'твор,мн'}], ['образование', {'твор,мн'}]]
ледяному берегу	[['ледяной', {'дат,ед'}], ['берег', {'дат,ед', 'местн,ед'}]]
ледяными гранями	[['ледяной', {'твор,мн'}], ['грань', {'твор,мн'}]]
ледяная вежливость	[['ледяной', {'им,ед'}], ['вежливость', {'вин,ед', 'им,ед'}]]
ледяные массивы	[['ледяной', {'вин,мн', 'им,мн'}], ['массив', {'вин,мн', 'им,мн'}]]
ледяному ветру	[['ледяной', {'дат,ед'}], ['ветер', {'дат,ед', 'местн,ед'}]]
ледяными перемычками	[['ледяной', {'твор,мн'}], ['перемычка', {'твор,мн'}]]
ледяной тюрьме	[['ледяной', {'твор,ед', 'пр,ед', 'дат,ед', 'им,ед', 'род,ед', 'вин,ед'}], ['тюрьма', {'дат,ед', 'пр,ед'}]]
ледяной воды	[['ледяной', {'твор,ед', 'пр,ед', 'дат,ед', 'им,ед', 'род,ед', 'вин,ед'}], ['вода', {'вин,мн', 'род,ед', 'им,мн'}]]
ледяных частиц	[['ледяной', {'пр,мн', 'род,мн', 'вин,мн'}], ['частица', {'род,мн'}]]
ледяной крошкой	[['ледяной', {'твор,ед', 'пр,ед', 'дат,ед', 'им,ед', 'род,ед', 'вин,ед'}], ['крошка', {'твор,ед'}]]
ледяной высоте	[['ледяной', {'твор,ед', 'пр,ед', 'дат,ед', 'им,ед', 'род,ед', 'вин,ед'}], ['высота', {'дат,ед', 'пр,ед'}]]
ледяных переправ	[['ледяной', {'пр,мн', 'род,мн', 'вин,мн'}], ['переправа', {'род,мн'}]]
ледяные дорожки	[['ледяной', {'вин,мн', 'им,мн'}], ['дорожка', {'вин,мн', 'род,ед', 'им,мн'}]]
ледяных дорогах	[['ледяной', {'пр,мн', 'род,мн', 'вин,мн'}], ['дорога', {'пр,мн'}]]
ледяные горки	[['ледяной', {'вин,мн', 'им,мн'}], ['горка', {'вин,мн', 'род,ед', 'им,мн'}]]
ледяные дома	[['ледяной', {'вин,мн', 'им,мн'}], ['дом', {'вин,мн', 'род,ед', 'им,мн'}]]
ледяные пылинки	[['ледяной', {'вин,мн', 'им,мн'}], ['пылинка', {'вин,мн', 'род,ед', 'им,мн'}]]
ледяной пещере	[['ледяной', {'твор,ед', 'пр,ед', 'дат,ед', 'им,ед', 'род,ед', 'вин,ед'}], ['пещера', {'дат,ед', 'пр,ед'}]]
ледяным дуновением	[['ледяной', {'дат,мн', 'твор,ед'}], ['дуновение', {'твор,ед'}]]
ледяными кубиками	[['ледяной', {'твор,мн'}], ['кубик', {'твор,мн'}]]
ледяному массиву	[['ледяной', {'дат,ед'}], ['массив', {'дат,ед'}]]
ледяной росе	[['ледяной', {'твор,ед', 'пр,ед', 'дат,ед', 'им,ед', 'род,ед', 'вин,ед'}], ['роса', {'дат,ед', 'пр,ед'}]]
ледяного пота	[['ледяной', {'род,ед', 'вин,ед'}], ['пот', {'род,ед'}]]
ледяных ветров	[['ледяной', {'пр,мн', 'род,мн', 'вин,мн'}], ['ветер', {'род,мн'}]]
ледяные барьеры	[['ледяной', {'вин,мн', 'им,мн'}], ['барьер', {'вин,мн', 'им,мн'}]]
ледяных волн	[['ледяной', {'пр,мн', 'род,мн', 'вин,мн'}], ['волна', {'род,мн'}]]
ледяной тропинке	[['ледяной', {'твор,ед', 'пр,ед', 'дат,ед', 'им,ед', 'род,ед', 'вин,ед'}], ['тропинка', {'дат,ед', 'пр,ед'}]]
ледяным дыханием	[['ледяной', {'дат,мн', 'твор,ед'}], ['дыхание', {'твор,ед'}]]
ледяной реке	[['ледяной', {'твор,ед', 'пр,ед', 'дат,ед', 'им,ед', 'род,ед', 'вин,ед'}], ['река', {'дат,ед', 'пр,ед'}]]
ледяных складах	[['ледяной', {'пр,мн', 'род,мн', 'вин,мн'}], ['склад', {'пр,мн'}]]
ледяную горку	[['ледяной', {'вин,ед'}], ['горка', {'вин,ед'}]]
ледяную вершину	[['ледяной', {'вин,ед'}], ['вершина', {'вин,ед'}]]
ледяные взгляды	[['ледяной', {'вин,мн', 'им,мн'}], ['взгляд', {'вин,мн', 'им,мн'}]]
ледяной волны	[['ледяной', {'твор,ед', 'пр,ед', 'дат,ед', 'им,ед', 'род,ед', 'вин,ед'}], ['волна', {'вин,мн', 'род,ед', 'им,мн'}]]
ледяном щите	[['ледяной', {'пр,ед'}], ['щит', {'пр,ед'}]]
ледяного плато	[['ледяной', {'род,ед', 'вин,ед'}], ['плато', {'род,мн', 'твор,ед', 'вин,мн', 'пр,ед', 'им,мн', 'дат,ед', 'им,ед', 'твор,мн', 'род,ед', 'вин,ед', 'пр,мн', 'дат,мн'}]]
ледяным стенам	[['ледяной', {'дат,мн', 'твор,ед'}], ['стена', {'дат,мн'}]]
ледяных струях	[['ледяной', {'пр,мн', 'род,мн', 'вин,мн'}], ['струя', {'пр,мн'}]]
ледяные залежи	[['ледяной', {'вин,мн', 'им,мн'}], ['залежи', {'вин,мн', 'им,мн'}]]
ледяных фигур	[['ледяной', {'пр,мн', 'род,мн', 'вин,мн'}], ['фигура', {'род,мн'}]]
ледяное стекло	[['ледяной', {'вин,ед', 'им,ед'}], ['стекло', {'вин,ед', 'им,ед'}]]
ледяных катков	[['ледяной', {'пр,мн', 'род,мн', 'вин,мн'}], ['каток', {'род,мн'}]]
ледяной массы	[['ледяной', {'твор,ед', 'пр,ед', 'дат,ед', 'им,ед', 'род,ед', 'вин,ед'}], ['масса', {'вин,мн', 'род,ед', 'им,мн'}]]
ледяное дно	[['ледяной', {'вин,ед', 'им,ед'}], ['дно', {'вин,ед', 'им,ед'}]]
ледяные лучи	[['ледяной', {'вин,мн', 'им,мн'}], ['луч', {'вин,мн', 'им,мн'}]]
ледяным берегам	[['ледяной', {'дат,мн', 'твор,ед'}], ['берег', {'дат,мн'}]]
ледяным блеском	[['ледяной', {'дат,мн', 'твор,ед'}], ['блеск', {'твор,ед'}]]
ледяную скорлупу	[['ледяной', {'вин,ед'}], ['скорлупа', {'вин,ед'}]]
ледяной Антарктиды	[['ледяной', {'твор,ед', 'пр,ед', 'дат,ед', 'им,ед', 'род,ед', 'вин,ед'}], ['антарктида', {'род,ед'}]]
ледяных узоров	[['ледяной', {'пр,мн', 'род,мн', 'вин,мн'}], ['узор', {'род,мн'}]]
ледяного кольца	[['ледяной', {'род,ед', 'вин,ед'}], ['кольцо', {'вин,мн', 'род,ед', 'им,мн'}]]
ледяными жилами	[['ледяной', {'твор,мн'}], ['жила', {'твор,мн'}]]
ледяное вино	[['ледяной', {'вин,ед', 'им,ед'}], ['вино', {'вин,ед', 'им,ед'}]]
ледяные капли	[['ледяной', {'вин,мн', 'им,мн'}], ['капля', {'вин,мн', 'род,ед', 'им,мн'}]]
ледяных языков	[['ледяной', {'пр,мн', 'род,мн', 'вин,мн'}], ['язык', {'род,мн'}]]
ледяные оболочки	[['ледяной', {'вин,мн', 'им,мн'}], ['оболочка', {'вин,мн', 'род,ед', 'им,мн'}]]
ледяные латы	[['ледяной', {'вин,мн', 'им,мн'}], ['латы', {'вин,мн', 'им,мн'}]]
ледяное окошко	[['ледяной', {'вин,ед', 'им,ед'}], ['окошко', {'вин,ед', 'им,ед'}]]
ледяном окне	[['ледяной', {'пр,ед'}], ['окно', {'пр,ед'}]]
ледяных покрытий	[['ледяной', {'пр,мн', 'род,мн', 'вин,мн'}], ['покрытие', {'род,мн'}]]
ледяные формы	[['ледяной', {'вин,мн', 'им,мн'}], ['форма', {'вин,мн', 'род,ед', 'им,мн'}]]
ледяного шельфа	[['ледяной', {'род,ед', 'вин,ед'}], ['шельф', {'род,ед'}]]
ледяному плато	[['ледяной', {'дат,ед'}], ['плато', {'род,мн', 'твор,ед', 'вин,мн', 'пр,ед', 'им,мн', 'дат,ед', 'им,ед', 'твор,мн', 'род,ед', 'вин,ед', 'пр,мн', 'дат,мн'}]]
ледяными горами	[['ледяной', {'твор,мн'}], ['гора', {'твор,мн'}]]
ледяным компрессом	[['ледяной', {'дат,мн', 'твор,ед'}], ['компресс', {'твор,ед'}]]
ледяной оболочки	[['ледяной', {'твор,ед', 'пр,ед', 'дат,ед', 'им,ед', 'род,ед', 'вин,ед'}], ['оболочка', {'вин,мн', 'род,ед', 'им,мн'}]]
ледяному стеклу	[['ледяной', {'дат,ед'}], ['стекло', {'дат,ед'}]]
ледяной родник	[['ледяной', {'твор,ед', 'пр,ед', 'дат,ед', 'им,ед', 'род,ед', 'вин,ед'}], ['родник', {'вин,ед', 'им,ед'}]]
ледяных стебельков	[['ледяной', {'пр,мн', 'род,мн', 'вин,мн'}], ['стебелек', {'род,мн'}]]
ледяном его	[['ледяной', {'пр,ед'}], ['он', {'род,ед', 'вин,ед'}]]
ледяная крошка	[['ледяной', {'им,ед'}], ['крошка', {'им,ед'}]]
ледяного края	[['ледяной', {'род,ед', 'вин,ед'}], ['край', {'вин,мн', 'род,ед', 'им,мн'}]]
ледяными шлирами	[['ледяной', {'твор,мн'}], ['шлир', {'твор,мн'}]]
ледяных образованиях	[['ледяной', {'пр,мн', 'род,мн', 'вин,мн'}], ['образование', {'пр,мн'}]]
ледяная заря	[['ледяной', {'им,ед'}], ['заря', {'им,ед'}]]
ледяном ветре	[['ледяной', {'пр,ед'}], ['ветер', {'пр,ед'}]]
ледяную пропасть	[['ледяной', {'вин,ед'}], ['пропасть', {'вин,ед', 'им,ед'}]]
ледяной перемычкой	[['ледяной', {'твор,ед', 'пр,ед', 'дат,ед', 'им,ед', 'род,ед', 'вин,ед'}], ['перемычка', {'твор,ед'}]]
ледяных просторов	[['ледяной', {'пр,мн', 'род,мн', 'вин,мн'}], ['простор', {'род,мн'}]]
ледяная пропасть	[['ледяной', {'им,ед'}], ['пропасть', {'вин,ед', 'им,ед'}]]
ледяной холодности	[['ледяной', {'твор,ед', 'пр,ед', 'дат,ед', 'им,ед', 'род,ед', 'вин,ед'}], ['холодность', {'вин,мн', 'дат,ед', 'пр,ед', 'род,ед', 'им,мн'}]]
ледяному валу	[['ледяной', {'дат,ед'}], ['вал', {'дат,ед', 'местн,ед'}]]
ледяных тисков	[['ледяной', {'пр,мн', 'род,мн', 'вин,мн'}], ['тиски', {'род,мн'}]]
ледяными шариками	[['ледяной', {'твор,мн'}], ['шарик', {'твор,мн'}]]
ледяной толщи	[['ледяной', {'твор,ед', 'пр,ед', 'дат,ед', 'им,ед', 'род,ед', 'вин,ед'}], ['толща', {'вин,мн', 'род,ед', 'им,мн'}]]
ледяные дожди	[['ледяной', {'вин,мн', 'им,мн'}], ['дождь', {'вин,мн', 'им,мн'}]]
ледяная пыль	[['ледяной', {'им,ед'}], ['пыль', {'вин,ед', 'им,ед'}]]
ледяного покровов	[['ледяной', {'род,ед', 'вин,ед'}], ['покров', {'род,мн'}]]
ледяные ключи	[['ледяной', {'вин,мн', 'им,мн'}], ['ключ', {'вин,мн', 'им,мн'}]]
ледяной шугой	[['ледяной', {'твор,ед', 'пр,ед', 'дат,ед', 'им,ед', 'род,ед', 'вин,ед'}], ['шуга', {'твор,ед'}]]
ледяной склад	[['ледяной', {'твор,ед', 'пр,ед', 'дат,ед', 'им,ед', 'род,ед', 'вин,ед'}], ['склад', {'вин,ед', 'им,ед'}]]
ледяными сосульками	[['ледяной', {'твор,мн'}], ['сосулька', {'твор,мн'}]]
ледяных барьеров	[['ледяной', {'пр,мн', 'род,мн', 'вин,мн'}], ['барьер', {'род,мн'}]]
ледяным огнем	[['ледяной', {'дат,мн', 'твор,ед'}], ['огонь', {'твор,ед'}]]
ледяное одиночество	[['ледяной', {'вин,ед', 'им,ед'}], ['одиночество', {'вин,ед', 'им,ед'}]]
ледяную прослойку	[['ледяной', {'вин,ед'}], ['прослойка', {'вин,ед'}]]
ледяной остров	[['ледяной', {'твор,ед', 'пр,ед', 'дат,ед', 'им,ед', 'род,ед', 'вин,ед'}], ['остров', {'вин,ед', 'им,ед'}]]
ледяной щит	[['ледяной', {'твор,ед', 'пр,ед', 'дат,ед', 'им,ед', 'род,ед', 'вин,ед'}], ['щит', {'вин,ед', 'им,ед'}]]
ледяную твердь	[['ледяной', {'вин,ед'}], ['твердь', {'вин,ед', 'им,ед'}]]
ледяную полынью	[['ледяной', {'вин,ед'}], ['полынь', {'твор,ед'}]]
ледяная ванна	[['ледяной', {'им,ед'}], ['ванна', {'им,ед'}]]
ледяной тундре	[['ледяной', {'твор,ед', 'пр,ед', 'дат,ед', 'им,ед', 'род,ед', 'вин,ед'}], ['тундра', {'дат,ед', 'пр,ед'}]]
ледяная рябь	[['ледяной', {'им,ед'}], ['рябь', {'вин,ед', 'им,ед'}]]
ледяных преград	[['ледяной', {'пр,мн', 'род,мн', 'вин,мн'}], ['преграда', {'род,мн'}]]
ледяной холодъ	[['ледяной', {'твор,ед', 'пр,ед', 'дат,ед', 'им,ед', 'род,ед', 'вин,ед'}], ['холод', {'вин,ед', 'им,ед'}]]
ледяную кромку	[['ледяной', {'вин,ед'}], ['кромка', {'вин,ед'}]]
ледяная луна	[['ледяной', {'им,ед'}], ['луна', {'им,ед'}]]
ледяному потоку	[['ледяной', {'дат,ед'}], ['поток', {'дат,ед'}]]
ледяные массы	[['ледяной', {'вин,мн', 'им,мн'}], ['масса', {'вин,мн', 'род,ед', 'им,мн'}]]
ледяного острова	[['ледяной', {'род,ед', 'вин,ед'}], ['остров', {'вин,мн', 'род,ед', 'им,мн'}]]
ледяного душа	[['ледяной', {'род,ед', 'вин,ед'}], ['душа', {'им,ед'}]]
ледяной Сибири	[['ледяной', {'твор,ед', 'пр,ед', 'дат,ед', 'им,ед', 'род,ед', 'вин,ед'}], ['сибирь', {'вин,мн', 'дат,ед', 'пр,ед', 'род,ед', 'им,мн'}]]
ледяном ложе	[['ледяной', {'пр,ед'}], ['ложе', {'пр,ед', 'вин,ед', 'им,ед'}]]
ледяной кромки	[['ледяной', {'твор,ед', 'пр,ед', 'дат,ед', 'им,ед', 'род,ед', 'вин,ед'}], ['кромка', {'вин,мн', 'род,ед', 'им,мн'}]]
ледяное кольцо	[['ледяной', {'вин,ед', 'им,ед'}], ['кольцо', {'вин,ед', 'им,ед'}]]
ледяном аду	[['ледяной', {'пр,ед'}], ['ад', {'дат,ед', 'местн,ед'}]]
ледяную область	[['ледяной', {'вин,ед'}], ['область', {'вин,ед', 'им,ед'}]]
ледяное сало	[['ледяной', {'вин,ед', 'им,ед'}], ['сало', {'вин,ед', 'им,ед'}]]
ледяной струе	[['ледяной', {'твор,ед', 'пр,ед', 'дат,ед', 'им,ед', 'род,ед', 'вин,ед'}], ['струя', {'дат,ед', 'пр,ед'}]]
ледяной затор	[['ледяной', {'твор,ед', 'пр,ед', 'дат,ед', 'им,ед', 'род,ед', 'вин,ед'}], ['затор', {'вин,ед', 'им,ед'}]]
ледяных склонах	[['ледяной', {'пр,мн', 'род,мн', 'вин,мн'}], ['склон', {'пр,мн'}]]
ледяную коросту	[['ледяной', {'вин,ед'}], ['короста', {'вин,ед'}]]
ледяной камень	[['ледяной', {'твор,ед', 'пр,ед', 'дат,ед', 'им,ед', 'род,ед', 'вин,ед'}], ['камень', {'вин,ед', 'им,ед'}]]
ледяные разводы	[['ледяной', {'вин,мн', 'им,мн'}], ['развод', {'вин,мн', 'им,мн'}]]
ледяными окнами	[['ледяной', {'твор,мн'}], ['окно', {'твор,мн'}]]
ледяной обруч	[['ледяной', {'твор,ед', 'пр,ед', 'дат,ед', 'им,ед', 'род,ед', 'вин,ед'}], ['обруч', {'вин,ед', 'им,ед'}]]
ледяными кристалликами	[['ледяной', {'твор,мн'}], ['кристаллик', {'твор,мн'}]]
ледяным потолком	[['ледяной', {'дат,мн', 'твор,ед'}], ['потолок', {'твор,ед'}]]
ледяную Сибирь	[['ледяной', {'вин,ед'}], ['сибирь', {'вин,ед', 'им,ед'}]]
ледяные пленки	[['ледяной', {'вин,мн', 'им,мн'}], ['пленка', {'вин,мн', 'род,ед', 'им,мн'}]]
ледяных сфер	[['ледяной', {'пр,мн', 'род,мн', 'вин,мн'}], ['сфера', {'род,мн'}]]
ледяного моря	[['ледяной', {'род,ед', 'вин,ед'}], ['море', {'вин,мн', 'род,ед', 'им,мн'}]]
ледяных островах	[['ледяной', {'пр,мн', 'род,мн', 'вин,мн'}], ['остров', {'пр,мн'}]]
ледяной сырости	[['ледяной', {'твор,ед', 'пр,ед', 'дат,ед', 'им,ед', 'род,ед', 'вин,ед'}], ['сырость', {'вин,мн', 'дат,ед', 'пр,ед', 'род,ед', 'им,мн'}]]
ледяных бугров	[['ледяной', {'пр,мн', 'род,мн', 'вин,мн'}], ['бугор', {'род,мн'}]]
ледяными стеклами	[['ледяной', {'твор,мн'}], ['стекло', {'твор,мн'}]]
ледяной ручей	[['ледяной', {'твор,ед', 'пр,ед', 'дат,ед', 'им,ед', 'род,ед', 'вин,ед'}], ['ручей', {'вин,ед', 'им,ед'}]]
ледяной свет	[['ледяной', {'твор,ед', 'пр,ед', 'дат,ед', 'им,ед', 'род,ед', 'вин,ед'}], ['свет', {'вин,ед', 'им,ед'}]]
ледянее льдин	[['ледяной', {'срав'}], ['льдина', {'род,мн'}]]
ледяной проруби	[['ледяной', {'твор,ед', 'пр,ед', 'дат,ед', 'им,ед', 'род,ед', 'вин,ед'}], ['прорубь', {'вин,мн', 'дат,ед', 'пр,ед', 'род,ед', 'им,мн'}]]
ледяным сиянием	[['ледяной', {'дат,мн', 'твор,ед'}], ['сияние', {'твор,ед'}]]
ледяной печке	[['ледяной', {'твор,ед', 'пр,ед', 'дат,ед', 'им,ед', 'род,ед', 'вин,ед'}], ['печка', {'дат,ед', 'пр,ед'}]]
ледяную крупу	[['ледяной', {'вин,ед'}], ['крупа', {'вин,ед'}]]
ледяных пространствах	[['ледяной', {'пр,мн', 'род,мн', 'вин,мн'}], ['пространство', {'пр,мн'}]]
ледяных кернах	[['ледяной', {'пр,мн', 'род,мн', 'вин,мн'}], ['керн', {'пр,мн'}]]
ледяными берегами	[['ледяной', {'твор,мн'}], ['берег', {'твор,мн'}]]
ледяными потоками	[['ледяной', {'твор,мн'}], ['поток', {'твор,мн'}]]
ледяная струйка	[['ледяной', {'им,ед'}], ['струйка', {'им,ед'}]]
ледяная стенка	[['ледяной', {'им,ед'}], ['стенка', {'им,ед'}]]
ледяная дрожь	[['ледяной', {'им,ед'}], ['дрожь', {'вин,ед', 'им,ед'}]]
ледяную глыбу	[['ледяной', {'вин,ед'}], ['глыба', {'вин,ед'}]]
ледяном наросте	[['ледяной', {'пр,ед'}], ['нарост', {'пр,ед'}]]
ледяные дрова	[['ледяной', {'вин,мн', 'им,мн'}], ['дрова', {'вин,мн', 'им,мн'}]]
ледяном озере	[['ледяной', {'пр,ед'}], ['озеро', {'пр,ед'}]]
ледяных призм	[['ледяной', {'пр,мн', 'род,мн', 'вин,мн'}], ['призма', {'род,мн'}]]
ледяное солнце	[['ледяной', {'вин,ед', 'им,ед'}], ['солнце', {'пр,ед', 'вин,ед', 'им,ед'}]]
ледяные скалы	[['ледяной', {'вин,мн', 'им,мн'}], ['скала', {'вин,мн', 'род,ед', 'им,мн'}]]
ледяные ветра	[['ледяной', {'вин,мн', 'им,мн'}], ['ветер', {'вин,мн', 'род,ед', 'им,мн'}]]
ледяных камней	[['ледяной', {'пр,мн', 'род,мн', 'вин,мн'}], ['камень', {'род,мн'}]]
ледяного обрыва	[['ледяной', {'род,ед', 'вин,ед'}], ['обрыв', {'род,ед'}]]
ледяном месиве	[['ледяной', {'пр,ед'}], ['месиво', {'пр,ед'}]]
ледяную пещеру	[['ледяной', {'вин,ед'}], ['пещера', {'вин,ед'}]]
ледяной бахромы	[['ледяной', {'твор,ед', 'пр,ед', 'дат,ед', 'им,ед', 'род,ед', 'вин,ед'}], ['бахрома', {'вин,мн', 'род,ед', 'им,мн'}]]
ледяные выступы	[['ледяной', {'вин,мн', 'им,мн'}], ['выступ', {'вин,мн', 'им,мн'}]]
ледяную толщу	[['ледяной', {'вин,ед'}], ['толща', {'вин,ед'}]]
ледяной ненавистью	[['ледяной', {'твор,ед', 'пр,ед', 'дат,ед', 'им,ед', 'род,ед', 'вин,ед'}], ['ненависть', {'твор,ед'}]]
ледяных столбов	[['ледяной', {'пр,мн', 'род,мн', 'вин,мн'}], ['столб', {'род,мн'}]]
ледяной реки	[['ледяной', {'твор,ед', 'пр,ед', 'дат,ед', 'им,ед', 'род,ед', 'вин,ед'}], ['река', {'вин,мн', 'род,ед', 'им,мн'}]]
ледяным ядром	[['ледяной', {'дат,мн', 'твор,ед'}], ['ядро', {'твор,ед'}]]
ледяной пустоты	[['ледяной', {'твор,ед', 'пр,ед', 'дат,ед', 'им,ед', 'род,ед', 'вин,ед'}], ['пустота', {'вин,мн', 'род,ед', 'им,мн'}]]
ледяную стынь	[['ледяной', {'вин,ед'}], ['стыть', set()]]
ледяных страстей	[['ледяной', {'пр,мн', 'род,мн', 'вин,мн'}], ['страсть', {'род,мн'}]]
ледяные пробки	[['ледяной', {'вин,мн', 'им,мн'}], ['пробка', {'вин,мн', 'род,ед', 'им,мн'}]]
ледяная дорога	[['ледяной', {'им,ед'}], ['дорога', {'им,ед'}]]
ледяной стране	[['ледяной', {'твор,ед', 'пр,ед', 'дат,ед', 'им,ед', 'род,ед', 'вин,ед'}], ['страна', {'дат,ед', 'пр,ед'}]]
ледяная кашица	[['ледяной', {'им,ед'}], ['кашица', {'им,ед'}]]
ледяного царства	[['ледяной', {'род,ед', 'вин,ед'}], ['царство', {'вин,мн', 'род,ед', 'им,мн'}]]
ледяным посохом	[['ледяной', {'дат,мн', 'твор,ед'}], ['посох', {'твор,ед'}]]
ледяные лавины	[['ледяной', {'вин,мн', 'им,мн'}], ['лавина', {'вин,мн', 'род,ед', 'им,мн'}]]
ледяного неба	[['ледяной', {'род,ед', 'вин,ед'}], ['небо', {'вин,мн', 'род,ед', 'им,мн'}]]
ледяных пластин	[['ледяной', {'пр,мн', 'род,мн', 'вин,мн'}], ['пластина', {'род,мн'}]]
ледяной камере	[['ледяной', {'твор,ед', 'пр,ед', 'дат,ед', 'им,ед', 'род,ед', 'вин,ед'}], ['камера', {'дат,ед', 'пр,ед'}]]
ледяного дождя	[['ледяной', {'род,ед', 'вин,ед'}], ['дождь', {'род,ед'}]]
ледяная бездна	[['ледяной', {'им,ед'}], ['бездна', {'им,ед'}]]
ледяных спутниках	[['ледяной', {'пр,мн', 'род,мн', 'вин,мн'}], ['спутник', {'пр,мн'}]]
ледяной потокъ	[['ледяной', {'твор,ед', 'пр,ед', 'дат,ед', 'им,ед', 'род,ед', 'вин,ед'}], ['поток', {'вин,ед', 'им,ед'}]]
ледяного взгляда	[['ледяной', {'род,ед', 'вин,ед'}], ['взгляд', {'род,ед'}]]
ледяной цилиндр	[['ледяной', {'твор,ед', 'пр,ед', 'дат,ед', 'им,ед', 'род,ед', 'вин,ед'}], ['цилиндр', {'вин,ед', 'им,ед'}]]
ледяной купол	[['ледяной', {'твор,ед', 'пр,ед', 'дат,ед', 'им,ед', 'род,ед', 'вин,ед'}], ['купол', {'вин,ед', 'им,ед'}]]
ледяным безмолвием	[['ледяной', {'дат,мн', 'твор,ед'}], ['безмолвие', {'твор,ед'}]]
ледяном карцере	[['ледяной', {'пр,ед'}], ['карцер', {'пр,ед'}]]
ледяная маска	[['ледяной', {'им,ед'}], ['маска', {'им,ед'}]]
ледяными обломками	[['ледяной', {'твор,мн'}], ['обломок', {'твор,мн'}]]
ледяным катком	[['ледяной', {'дат,мн', 'твор,ед'}], ['каток', {'твор,ед'}]]
ледяная частица	[['ледяной', {'им,ед'}], ['частица', {'им,ед'}]]
ледяного сока	[['ледяной', {'род,ед', 'вин,ед'}], ['сок', {'род,ед'}]]
ледяными телами	[['ледяной', {'твор,мн'}], ['тело', {'твор,мн'}]]
ледяные губы	[['ледяной', {'вин,мн', 'им,мн'}], ['губа', {'вин,мн', 'род,ед', 'им,мн'}]]
ледяного языка	[['ледяной', {'род,ед', 'вин,ед'}], ['язык', {'род,ед'}]]
ледяной раствор	[['ледяной', {'твор,ед', 'пр,ед', 'дат,ед', 'им,ед', 'род,ед', 'вин,ед'}], ['раствор', {'вин,ед', 'им,ед'}]]
ледяные волны	[['ледяной', {'вин,мн', 'им,мн'}], ['волна', {'вин,мн', 'род,ед', 'им,мн'}]]
ледяной купели	[['ледяной', {'твор,ед', 'пр,ед', 'дат,ед', 'им,ед', 'род,ед', 'вин,ед'}], ['купель', {'вин,мн', 'дат,ед', 'пр,ед', 'род,ед', 'им,мн'}]]
ледяную прорубь	[['ледяной', {'вин,ед'}], ['прорубь', {'вин,ед', 'им,ед'}]]
ледяные цепи	[['ледяной', {'вин,мн', 'им,мн'}], ['цепь', {'вин,мн', 'дат,ед', 'пр,ед', 'род,ед', 'им,мн'}]]
ледяной преграды	[['ледяной', {'твор,ед', 'пр,ед', 'дат,ед', 'им,ед', 'род,ед', 'вин,ед'}], ['преграда', {'вин,мн', 'род,ед', 'им,мн'}]]
ледяной жилы	[['ледяной', {'твор,ед', 'пр,ед', 'дат,ед', 'им,ед', 'род,ед', 'вин,ед'}], ['жила', {'вин,мн', 'род,ед', 'им,мн'}]]
ледяной коркой	[['ледяной', {'твор,ед', 'пр,ед', 'дат,ед', 'им,ед', 'род,ед', 'вин,ед'}], ['корка', {'твор,ед'}]]
ледяное молчание	[['ледяной', {'вин,ед', 'им,ед'}], ['молчание', {'вин,ед', 'им,ед'}]]
ледяные островки	[['ледяной', {'вин,мн', 'им,мн'}], ['островок', {'вин,мн', 'им,мн'}]]
ледяному холоду	[['ледяной', {'дат,ед'}], ['холод', {'дат,ед', 'парт,ед'}]]
ледяную пластинку	[['ледяной', {'вин,ед'}], ['пластинка', {'вин,ед'}]]
ледяной паутиной	[['ледяной', {'твор,ед', 'пр,ед', 'дат,ед', 'им,ед', 'род,ед', 'вин,ед'}], ['паутина', {'твор,ед'}]]
ледяной кубик	[['ледяной', {'твор,ед', 'пр,ед', 'дат,ед', 'им,ед', 'род,ед', 'вин,ед'}], ['кубик', {'вин,ед', 'им,ед'}]]
ледяной стуже	[['ледяной', {'твор,ед', 'пр,ед', 'дат,ед', 'им,ед', 'род,ед', 'вин,ед'}], ['стужа', {'дат,ед', 'пр,ед'}]]
ледяной учтивостью	[['ледяной', {'твор,ед', 'пр,ед', 'дат,ед', 'им,ед', 'род,ед', 'вин,ед'}], ['учтивость', {'твор,ед'}]]
ледяной синевы	[['ледяной', {'твор,ед', 'пр,ед', 'дат,ед', 'им,ед', 'род,ед', 'вин,ед'}], ['синева', {'вин,мн', 'род,ед', 'им,мн'}]]
ледяной норд	[['ледяной', {'твор,ед', 'пр,ед', 'дат,ед', 'им,ед', 'род,ед', 'вин,ед'}], ['норд', {'вин,ед', 'им,ед'}]]
ледяного монолита	[['ледяной', {'род,ед', 'вин,ед'}], ['монолит', {'род,ед'}]]
ледяному полюсу	[['ледяной', {'дат,ед'}], ['полюс', {'дат,ед'}]]
ледяное молчанье	[['ледяной', {'вин,ед', 'им,ед'}], ['молчание', {'пр,ед', 'вин,ед', 'им,ед'}]]
ледяной ук	[['ледяной', {'твор,ед', 'пр,ед', 'дат,ед', 'им,ед', 'род,ед', 'вин,ед'}], ['ук', {'вин,ед', 'им,ед'}]]
ледяным одеялом	[['ледяной', {'дат,мн', 'твор,ед'}], ['одеяло', {'твор,ед'}]]
ледяными мостами	[['ледяной', {'твор,мн'}], ['мост', {'твор,мн'}]]
ледяною пылью	[['ледяной', {'твор,ед'}], ['пыль', {'твор,ед'}]]
ледяном пространстве	[['ледяной', {'пр,ед'}], ['пространство', {'пр,ед'}]]
ледяной породы	[['ледяной', {'твор,ед', 'пр,ед', 'дат,ед', 'им,ед', 'род,ед', 'вин,ед'}], ['порода', {'вин,мн', 'род,ед', 'им,мн'}]]
ледяной снег	[['ледяной', {'твор,ед', 'пр,ед', 'дат,ед', 'им,ед', 'род,ед', 'вин,ед'}], ['снег', {'вин,ед', 'им,ед'}]]
ледяным равнодушием	[['ледяной', {'дат,мн', 'твор,ед'}], ['равнодушие', {'твор,ед'}]]
ледяном крошеве	[['ледяной', {'пр,ед'}], ['крошево', {'пр,ед'}]]
ледяные тела	[['ледяной', {'вин,мн', 'им,мн'}], ['тело', {'вин,мн', 'род,ед', 'им,мн'}]]
ледяной массой	[['ледяной', {'твор,ед', 'пр,ед', 'дат,ед', 'им,ед', 'род,ед', 'вин,ед'}], ['масса', {'твор,ед'}]]
ледяных пальцев	[['ледяной', {'пр,мн', 'род,мн', 'вин,мн'}], ['палец', {'род,мн'}]]
ледяной ножичек	[['ледяной', {'твор,ед', 'пр,ед', 'дат,ед', 'им,ед', 'род,ед', 'вин,ед'}], ['ножичек', {'вин,ед', 'им,ед'}]]
ледяной пленкой	[['ледяной', {'твор,ед', 'пр,ед', 'дат,ед', 'им,ед', 'род,ед', 'вин,ед'}], ['пленка', {'твор,ед'}]]
ледяной крышей	[['ледяной', {'твор,ед', 'пр,ед', 'дат,ед', 'им,ед', 'род,ед', 'вин,ед'}], ['крыша', {'твор,ед'}]]
ледяных руслах	[['ледяной', {'пр,мн', 'род,мн', 'вин,мн'}], ['русло', {'пр,мн'}]]
ледяной мути	[['ледяной', {'твор,ед', 'пр,ед', 'дат,ед', 'им,ед', 'род,ед', 'вин,ед'}], ['муть', {'вин,мн', 'дат,ед', 'пр,ед', 'род,ед', 'им,мн'}]]
ледяного молчания	[['ледяной', {'род,ед', 'вин,ед'}], ['молчание', {'вин,мн', 'род,ед', 'им,мн'}]]
ледяным квасом	[['ледяной', {'дат,мн', 'твор,ед'}], ['квас', {'твор,ед'}]]
ледяное слово	[['ледяной', {'вин,ед', 'им,ед'}], ['слово', {'вин,ед', 'им,ед'}]]
ледяного месива	[['ледяной', {'род,ед', 'вин,ед'}], ['месиво', {'вин,мн', 'род,ед', 'им,мн'}]]
ледяного лимонада	[['ледяной', {'род,ед', 'вин,ед'}], ['лимонад', {'род,ед'}]]
ледяной плотины	[['ледяной', {'твор,ед', 'пр,ед', 'дат,ед', 'им,ед', 'род,ед', 'вин,ед'}], ['плотина', {'вин,мн', 'род,ед', 'им,мн'}]]
ледяного образования	[['ледяной', {'род,ед', 'вин,ед'}], ['образование', {'вин,мн', 'род,ед', 'им,мн'}]]
ледяная зона	[['ледяной', {'им,ед'}], ['зона', {'им,ед'}]]
ледяные наплывы	[['ледяной', {'вин,мн', 'им,мн'}], ['наплыв', {'вин,мн', 'им,мн'}]]
ледяные плиты	[['ледяной', {'вин,мн', 'им,мн'}], ['плита', {'вин,мн', 'род,ед', 'им,мн'}]]
ледяным погребом	[['ледяной', {'дат,мн', 'твор,ед'}], ['погреб', {'твор,ед'}]]
ледяного материала	[['ледяной', {'род,ед', 'вин,ед'}], ['материал', {'род,ед'}]]
ледяных капель	[['ледяной', {'пр,мн', 'род,мн', 'вин,мн'}], ['капля', {'род,мн'}]]
ледяном сердце	[['ледяной', {'пр,ед'}], ['сердце', {'пр,ед', 'вин,ед', 'им,ед'}]]
ледяных камнях	[['ледяной', {'пр,мн', 'род,мн', 'вин,мн'}], ['камень', {'пр,мн'}]]
ледяной поток	[['ледяной', {'твор,ед', 'пр,ед', 'дат,ед', 'им,ед', 'род,ед', 'вин,ед'}], ['поток', {'вин,ед', 'им,ед'}]]
ледяной ночи	[['ледяной', {'твор,ед', 'пр,ед', 'дат,ед', 'им,ед', 'род,ед', 'вин,ед'}], ['ночь', {'вин,мн', 'местн,ед', 'пр,ед', 'им,мн', 'дат,ед', 'род,ед'}]]
ледяная роса	[['ледяной', {'им,ед'}], ['роса', {'им,ед'}]]
ледяного континента	[['ледяной', {'род,ед', 'вин,ед'}], ['континент', {'род,ед'}]]
ледяным холодом	[['ледяной', {'дат,мн', 'твор,ед'}], ['холод', {'твор,ед'}]]
ледяном небе	[['ледяной', {'пр,ед'}], ['небо', {'пр,ед'}]]
ледяной настил	[['ледяной', {'твор,ед', 'пр,ед', 'дат,ед', 'им,ед', 'род,ед', 'вин,ед'}], ['настил', {'вин,ед', 'им,ед'}]]
ледяными покровами	[['ледяной', {'твор,мн'}], ['покров', {'твор,мн'}]]
ледяные языки	[['ледяной', {'вин,мн', 'им,мн'}], ['язык', {'вин,мн', 'им,мн'}]]
ледяной шторм	[['ледяной', {'твор,ед', 'пр,ед', 'дат,ед', 'им,ед', 'род,ед', 'вин,ед'}], ['шторм', {'вин,ед', 'им,ед'}]]
ледяных оболочек	[['ледяной', {'пр,мн', 'род,мн', 'вин,мн'}], ['оболочка', {'род,мн'}]]
ледяные моря	[['ледяной', {'вин,мн', 'им,мн'}], ['море', {'вин,мн', 'род,ед', 'им,мн'}]]
ледяной прозрачности	[['ледяной', {'твор,ед', 'пр,ед', 'дат,ед', 'им,ед', 'род,ед', 'вин,ед'}], ['прозрачность', {'вин,мн', 'дат,ед', 'пр,ед', 'род,ед', 'им,мн'}]]
ледяных ядер	[['ледяной', {'пр,мн', 'род,мн', 'вин,мн'}], ['ядро', {'род,мн'}]]
ледяным языком	[['ледяной', {'дат,мн', 'твор,ед'}], ['язык', {'твор,ед'}]]
ледяными скалами	[['ледяной', {'твор,мн'}], ['скала', {'твор,мн'}]]
ледяной арене	[['ледяной', {'твор,ед', 'пр,ед', 'дат,ед', 'им,ед', 'род,ед', 'вин,ед'}], ['арена', {'дат,ед', 'пр,ед'}]]
ледяных дисков	[['ледяной', {'пр,мн', 'род,мн', 'вин,мн'}], ['диск', {'род,мн'}]]
ледяные жилы	[['ледяной', {'вин,мн', 'им,мн'}], ['жила', {'вин,мн', 'род,ед', 'им,мн'}]]
ледяной каток	[['ледяной', {'твор,ед', 'пр,ед', 'дат,ед', 'им,ед', 'род,ед', 'вин,ед'}], ['каток', {'вин,ед', 'им,ед'}]]
ледяной дробью	[['ледяной', {'твор,ед', 'пр,ед', 'дат,ед', 'им,ед', 'род,ед', 'вин,ед'}], ['дробь', {'твор,ед'}]]
ледяной горкой	[['ледяной', {'твор,ед', 'пр,ед', 'дат,ед', 'им,ед', 'род,ед', 'вин,ед'}], ['горка', {'твор,ед'}]]
ледяной пещеры	[['ледяной', {'твор,ед', 'пр,ед', 'дат,ед', 'им,ед', 'род,ед', 'вин,ед'}], ['пещера', {'вин,мн', 'род,ед', 'им,мн'}]]
ледяное железо	[['ледяной', {'вин,ед', 'им,ед'}], ['железо', {'вин,ед', 'им,ед'}]]
ледяную темноту	[['ледяной', {'вин,ед'}], ['темнота', {'вин,ед'}]]
ледяной баней	[['ледяной', {'твор,ед', 'пр,ед', 'дат,ед', 'им,ед', 'род,ед', 'вин,ед'}], ['баня', {'твор,ед'}]]
ледяных оков	[['ледяной', {'пр,мн', 'род,мн', 'вин,мн'}], ['оковы', {'род,мн'}]]
ледяную равнину	[['ледяной', {'вин,ед'}], ['равнина', {'вин,ед'}]]
ледяном сквозняке	[['ледяной', {'пр,ед'}], ['сквозняк', {'пр,ед'}]]
ледяные полосы	[['ледяной', {'вин,мн', 'им,мн'}], ['полоса', {'вин,мн', 'род,ед', 'им,мн'}]]
ледяными дровами	[['ледяной', {'твор,мн'}], ['дрова', {'твор,мн'}]]
ледяные выси	[['ледяной', {'вин,мн', 'им,мн'}], ['высь', {'вин,мн', 'дат,ед', 'пр,ед', 'род,ед', 'им,мн'}]]
ледяной корой	[['ледяной', {'твор,ед', 'пр,ед', 'дат,ед', 'им,ед', 'род,ед', 'вин,ед'}], ['кора', {'твор,ед'}]]
ледяному мосту	[['ледяной', {'дат,ед'}], ['мост', {'дат,ед', 'местн,ед'}]]
ледяную ванну	[['ледяной', {'вин,ед'}], ['ванна', {'вин,ед'}]]
ледяные комочки	[['ледяной', {'вин,мн', 'им,мн'}], ['комочек', {'вин,мн', 'им,мн'}]]
ледяной атмосфере	[['ледяной', {'твор,ед', 'пр,ед', 'дат,ед', 'им,ед', 'род,ед', 'вин,ед'}], ['атмосфера', {'дат,ед', 'пр,ед'}]]
ледяным цементом	[['ледяной', {'дат,мн', 'твор,ед'}], ['цемент', {'твор,ед'}]]
ледяной крупе	[['ледяной', {'твор,ед', 'пр,ед', 'дат,ед', 'им,ед', 'род,ед', 'вин,ед'}], ['крупа', {'дат,ед', 'пр,ед'}]]
ледяного склада	[['ледяной', {'род,ед', 'вин,ед'}], ['склад', {'род,ед'}]]
ледяных сооружений	[['ледяной', {'пр,мн', 'род,мн', 'вин,мн'}], ['сооружение', {'род,мн'}]]
ледяной пол	[['ледяной', {'твор,ед', 'пр,ед', 'дат,ед', 'им,ед', 'род,ед', 'вин,ед'}], ['пол', {'вин,ед', 'им,ед'}]]
ледяную избушку	[['ледяной', {'вин,ед'}], ['избушка', {'вин,ед'}]]
ледяной мантии	[['ледяной', {'твор,ед', 'пр,ед', 'дат,ед', 'им,ед', 'род,ед', 'вин,ед'}], ['мантия', {'вин,мн', 'дат,ед', 'пр,ед', 'род,ед', 'им,мн'}]]
ледяной площадке	[['ледяной', {'твор,ед', 'пр,ед', 'дат,ед', 'им,ед', 'род,ед', 'вин,ед'}], ['площадка', {'дат,ед', 'пр,ед'}]]
ледяных брызг	[['ледяной', {'пр,мн', 'род,мн', 'вин,мн'}], ['брызги', {'род,мн'}]]
ледяные пластинки	[['ледяной', {'вин,мн', 'им,мн'}], ['пластинка', {'вин,мн', 'род,ед', 'им,мн'}]]
ледяными узорами	[['ледяной', {'твор,мн'}], ['узор', {'твор,мн'}]]
ледяную ночь	[['ледяной', {'вин,ед'}], ['ночь', {'вин,ед', 'им,ед'}]]
ледяным пустыням	[['ледяной', {'дат,мн', 'твор,ед'}], ['пустыня', {'дат,мн'}]]
ледяному зеркалу	[['ледяной', {'дат,ед'}], ['зеркало', {'дат,ед'}]]
ледяных обломков	[['ледяной', {'пр,мн', 'род,мн', 'вин,мн'}], ['обломок', {'род,мн'}]]
ледяной керн	[['ледяной', {'твор,ед', 'пр,ед', 'дат,ед', 'им,ед', 'род,ед', 'вин,ед'}], ['керн', {'вин,ед', 'им,ед'}]]
ледяное нутро	[['ледяной', {'вин,ед', 'им,ед'}], ['нутро', {'вин,ед', 'им,ед'}]]
ледяного стекла	[['ледяной', {'род,ед', 'вин,ед'}], ['стекло', {'вин,мн', 'род,ед', 'им,мн'}]]
ледяного холода	[['ледяной', {'род,ед', 'вин,ед'}], ['холод', {'вин,мн', 'род,ед', 'им,мн'}]]
ледяной избы	[['ледяной', {'твор,ед', 'пр,ед', 'дат,ед', 'им,ед', 'род,ед', 'вин,ед'}], ['изба', {'вин,мн', 'род,ед', 'им,мн'}]]
ледяного слоя	[['ледяной', {'род,ед', 'вин,ед'}], ['слой', {'род,ед'}]]
ледяной броне	[['ледяной', {'твор,ед', 'пр,ед', 'дат,ед', 'им,ед', 'род,ед', 'вин,ед'}], ['броня', {'дат,ед', 'пр,ед'}]]
ледяными пробками	[['ледяной', {'твор,мн'}], ['пробка', {'твор,мн'}]]
ледяное дыхаше	[['ледяной', {'вин,ед', 'им,ед'}], ['дыхаш', {'пр,ед'}]]
ледяной кровью	[['ледяной', {'твор,ед', 'пр,ед', 'дат,ед', 'им,ед', 'род,ед', 'вин,ед'}], ['кровь', {'твор,ед'}]]
ледяных хранилищах	[['ледяной', {'пр,мн', 'род,мн', 'вин,мн'}], ['хранилище', {'пр,мн'}]]
ледяной холодок	[['ледяной', {'твор,ед', 'пр,ед', 'дат,ед', 'им,ед', 'род,ед', 'вин,ед'}], ['холодок', {'вин,ед', 'им,ед'}]]
ледяной шапкой	[['ледяной', {'твор,ед', 'пр,ед', 'дат,ед', 'им,ед', 'род,ед', 'вин,ед'}], ['шапка', {'твор,ед'}]]
ледяной спуск	[['ледяной', {'твор,ед', 'пр,ед', 'дат,ед', 'им,ед', 'род,ед', 'вин,ед'}], ['спуск', {'вин,ед', 'им,ед'}]]
ледяной покров	[['ледяной', {'твор,ед', 'пр,ед', 'дат,ед', 'им,ед', 'род,ед', 'вин,ед'}], ['покров', {'вин,ед', 'им,ед'}]]
ледяного голоса	[['ледяной', {'род,ед', 'вин,ед'}], ['голос', {'вин,мн', 'род,ед', 'им,мн'}]]
ледяной желоб	[['ледяной', {'твор,ед', 'пр,ед', 'дат,ед', 'им,ед', 'род,ед', 'вин,ед'}], ['желоб', {'вин,ед', 'им,ед'}]]
ледяным обручем	[['ледяной', {'дат,мн', 'твор,ед'}], ['обруч', {'твор,ед'}]]
ледяной пучине	[['ледяной', {'твор,ед', 'пр,ед', 'дат,ед', 'им,ед', 'род,ед', 'вин,ед'}], ['пучина', {'дат,ед', 'пр,ед'}]]
ледяная короста	[['ледяной', {'им,ед'}], ['короста', {'им,ед'}]]
ледяного безмолвия	[['ледяной', {'род,ед', 'вин,ед'}], ['безмолвие', {'вин,мн', 'род,ед', 'им,мн'}]]
ледяным серебром	[['ледяной', {'дат,мн', 'твор,ед'}], ['серебро', {'твор,ед'}]]
ледяной России	[['ледяной', {'твор,ед', 'пр,ед', 'дат,ед', 'им,ед', 'род,ед', 'вин,ед'}], ['россия', {'вин,мн', 'дат,ед', 'пр,ед', 'род,ед', 'им,мн'}]]
ледяная глыба	[['ледяной', {'им,ед'}], ['глыба', {'им,ед'}]]
ледяных плато	[['ледяной', {'пр,мн', 'род,мн', 'вин,мн'}], ['плато', {'род,мн', 'твор,ед', 'вин,мн', 'пр,ед', 'им,мн', 'дат,ед', 'им,ед', 'твор,мн', 'род,ед', 'вин,ед', 'пр,мн', 'дат,мн'}]]
ледяного узора	[['ледяной', {'род,ед', 'вин,ед'}], ['узор', {'род,ед'}]]
ледяные корки	[['ледяной', {'вин,мн', 'им,мн'}], ['корка', {'вин,мн', 'род,ед', 'им,мн'}]]
ледяная пещера	[['ледяной', {'им,ед'}], ['пещера', {'им,ед'}]]
ледяных высот	[['ледяной', {'пр,мн', 'род,мн', 'вин,мн'}], ['высота', {'род,мн'}]]
ледяным куском	[['ледяной', {'дат,мн', 'твор,ед'}], ['кусок', {'твор,ед'}]]
ледяные стекла	[['ледяной', {'вин,мн', 'им,мн'}], ['стекло', {'вин,мн', 'род,ед', 'им,мн'}]]
ледяное оконце	[['ледяной', {'вин,ед', 'им,ед'}], ['оконце', {'пр,ед', 'вин,ед', 'им,ед'}]]
ледяного цемента	[['ледяной', {'род,ед', 'вин,ед'}], ['цемент', {'род,ед'}]]
ледяной влагой	[['ледяной', {'твор,ед', 'пр,ед', 'дат,ед', 'им,ед', 'род,ед', 'вин,ед'}], ['влага', {'твор,ед'}]]
ледяные утесы	[['ледяной', {'вин,мн', 'им,мн'}], ['утес', {'вин,мн', 'им,мн'}]]
ледяная тишина	[['ледяной', {'им,ед'}], ['тишина', {'им,ед'}]]
ледяных торосах	[['ледяной', {'пр,мн', 'род,мн', 'вин,мн'}], ['торос', {'пр,мн'}]]
ледяную бездну	[['ледяной', {'вин,ед'}], ['бездна', {'вин,ед'}]]
ледяной бетон	[['ледяной', {'твор,ед', 'пр,ед', 'дат,ед', 'им,ед', 'род,ед', 'вин,ед'}], ['бетон', {'вин,ед', 'им,ед'}]]
ледяного ожога	[['ледяной', {'род,ед', 'вин,ед'}], ['ожог', {'род,ед'}]]
ледяного грота	[['ледяной', {'род,ед', 'вин,ед'}], ['грот', {'род,ед'}]]
ледяными горками	[['ледяной', {'твор,мн'}], ['горка', {'твор,мн'}]]
ледяных глыбах	[['ледяной', {'пр,мн', 'род,мн', 'вин,мн'}], ['глыба', {'пр,мн'}]]
ледяного Казбека	[['ледяной', {'род,ед', 'вин,ед'}], ['казбек', {'род,ед', 'вин,ед'}]]
ледяную купель	[['ледяной', {'вин,ед'}], ['купель', {'вин,ед', 'им,ед'}]]
ледяной Антарктиде	[['ледяной', {'твор,ед', 'пр,ед', 'дат,ед', 'им,ед', 'род,ед', 'вин,ед'}], ['антарктида', {'дат,ед', 'пр,ед'}]]
ледяном плену	[['ледяной', {'пр,ед'}], ['плен', {'дат,ед', 'местн,ед'}]]
ледяного ада	[['ледяной', {'род,ед', 'вин,ед'}], ['ад', {'род,ед'}]]
ледяных дельфина	[['ледяной', {'пр,мн', 'род,мн', 'вин,мн'}], ['дельфин', {'род,ед', 'вин,ед'}]]
ледяной ясностью	[['ледяной', {'твор,ед', 'пр,ед', 'дат,ед', 'им,ед', 'род,ед', 'вин,ед'}], ['ясность', {'твор,ед'}]]
ледяным хладнокровием	[['ледяной', {'дат,мн', 'твор,ед'}], ['хладнокровие', {'твор,ед'}]]
ледяная гора	[['ледяной', {'им,ед'}], ['гора', {'им,ед'}]]
ледяные иглы	[['ледяной', {'вин,мн', 'им,мн'}], ['игла', {'вин,мн', 'род,ед', 'им,мн'}]]
ледяных бунтов	[['ледяной', {'пр,мн', 'род,мн', 'вин,мн'}], ['бунт', {'род,мн'}]]
ледяную жидкость	[['ледяной', {'вин,ед'}], ['жидкость', {'вин,ед', 'им,ед'}]]
ледяные скульптуры	[['ледяной', {'вин,мн', 'им,мн'}], ['скульптура', {'вин,мн', 'род,ед', 'им,мн'}]]
ледяные сталагмиты	[['ледяной', {'вин,мн', 'им,мн'}], ['сталагмит', {'вин,мн', 'им,мн'}]]
ледяной рев	[['ледяной', {'твор,ед', 'пр,ед', 'дат,ед', 'им,ед', 'род,ед', 'вин,ед'}], ['рев', {'вин,ед', 'им,ед'}]]
ледяные заторы	[['ледяной', {'вин,мн', 'им,мн'}], ['затор', {'вин,мн', 'им,мн'}]]
ледяных струй	[['ледяной', {'пр,мн', 'род,мн', 'вин,мн'}], ['струя', {'род,мн'}]]
ледяным кристаллам	[['ледяной', {'дат,мн', 'твор,ед'}], ['кристалл', {'дат,мн'}]]
ледяные походы	[['ледяной', {'вин,мн', 'им,мн'}], ['поход', {'вин,мн', 'им,мн'}]]
ледяные слова	[['ледяной', {'вин,мн', 'им,мн'}], ['слово', {'вин,мн', 'род,ед', 'им,мн'}]]
ледяной стенке	[['ледяной', {'твор,ед', 'пр,ед', 'дат,ед', 'им,ед', 'род,ед', 'вин,ед'}], ['стенка', {'дат,ед', 'пр,ед'}]]
ледяных буграх	[['ледяной', {'пр,мн', 'род,мн', 'вин,мн'}], ['бугор', {'пр,мн'}]]
ледяные столбы	[['ледяной', {'вин,мн', 'им,мн'}], ['столб', {'вин,мн', 'им,мн'}]]
ледяную даль	[['ледяной', {'вин,ед'}], ['даль', {'вин,ед', 'им,ед'}]]
ледяных холмов	[['ледяной', {'пр,мн', 'род,мн', 'вин,мн'}], ['холм', {'род,мн'}]]
ледяную полосу	[['ледяной', {'вин,ед'}], ['полоса', {'вин,ед'}]]
ледяным раствором	[['ледяной', {'дат,мн', 'твор,ед'}], ['раствор', {'твор,ед'}]]
ледяная переправа	[['ледяной', {'им,ед'}], ['переправа', {'им,ед'}]]
ледяному полю	[['ледяной', {'дат,ед'}], ['поле', {'дат,ед'}]]
ледяной лишай	[['ледяной', {'твор,ед', 'пр,ед', 'дат,ед', 'им,ед', 'род,ед', 'вин,ед'}], ['лишать', set()]]
ледяная модель	[['ледяной', {'им,ед'}], ['модель', {'вин,ед', 'им,ед'}]]
ледяные глубины	[['ледяной', {'вин,мн', 'им,мн'}], ['глубина', {'вин,мн', 'род,ед', 'им,мн'}]]
ледяной узор	[['ледяной', {'твор,ед', 'пр,ед', 'дат,ед', 'им,ед', 'род,ед', 'вин,ед'}], ['узор', {'вин,ед', 'им,ед'}]]
ледяному желобу	[['ледяной', {'дат,ед'}], ['желоб', {'дат,ед'}]]
ледяной шуге	[['ледяной', {'твор,ед', 'пр,ед', 'дат,ед', 'им,ед', 'род,ед', 'вин,ед'}], ['шуга', {'дат,ед', 'пр,ед'}]]
ледяным поясом	[['ледяной', {'дат,мн', 'твор,ед'}], ['пояс', {'твор,ед'}]]
ледяные окопы	[['ледяной', {'вин,мн', 'им,мн'}], ['окоп', {'вин,мн', 'им,мн'}]]
ледяные сумерки	[['ледяной', {'вин,мн', 'им,мн'}], ['сумерки', {'вин,мн', 'им,мн'}]]
ледяной погреб	[['ледяной', {'твор,ед', 'пр,ед', 'дат,ед', 'им,ед', 'род,ед', 'вин,ед'}], ['погреб', {'вин,ед', 'им,ед'}]]
ледяные осколки	[['ледяной', {'вин,мн', 'им,мн'}], ['осколок', {'вин,мн', 'им,мн'}]]
ледяному припаю	[['ледяной', {'дат,ед'}], ['припай', {'дат,ед'}]]
ледяной пробки	[['ледяной', {'твор,ед', 'пр,ед', 'дат,ед', 'им,ед', 'род,ед', 'вин,ед'}], ['пробка', {'вин,мн', 'род,ед', 'им,мн'}]]
ледяная оболочка	[['ледяной', {'им,ед'}], ['оболочка', {'им,ед'}]]
ледяные пещеры	[['ледяной', {'вин,мн', 'им,мн'}], ['пещера', {'вин,мн', 'род,ед', 'им,мн'}]]
ледяных стенах	[['ледяной', {'пр,мн', 'род,мн', 'вин,мн'}], ['стена', {'пр,мн'}]]
ледяным спокойствием	[['ледяной', {'дат,мн', 'твор,ед'}], ['спокойствие', {'твор,ед'}]]
ледяного крошева	[['ледяной', {'род,ед', 'вин,ед'}], ['крошево', {'вин,мн', 'род,ед', 'им,мн'}]]
ледяной буран	[['ледяной', {'твор,ед', 'пр,ед', 'дат,ед', 'им,ед', 'род,ед', 'вин,ед'}], ['буран', {'вин,ед', 'им,ед'}]]
ледяной жиле	[['ледяной', {'твор,ед', 'пр,ед', 'дат,ед', 'им,ед', 'род,ед', 'вин,ед'}], ['жила', {'дат,ед', 'пр,ед'}]]
ледяной вершиной	[['ледяной', {'твор,ед', 'пр,ед', 'дат,ед', 'им,ед', 'род,ед', 'вин,ед'}], ['вершина', {'твор,ед'}]]
ледяными иголочками	[['ледяной', {'твор,мн'}], ['иголочка', {'твор,мн'}]]
ледяную тундру	[['ледяной', {'вин,ед'}], ['тундра', {'вин,ед'}]]
ледяной голос	[['ледяной', {'твор,ед', 'пр,ед', 'дат,ед', 'им,ед', 'род,ед', 'вин,ед'}], ['голос', {'вин,ед', 'им,ед'}]]
ледяных пробок	[['ледяной', {'пр,мн', 'род,мн', 'вин,мн'}], ['пробка', {'род,мн'}]]
ледяной рыбы	[['ледяной', {'твор,ед', 'пр,ед', 'дат,ед', 'им,ед', 'род,ед', 'вин,ед'}], ['рыба', {'род,ед', 'им,мн'}]]
ледяным пламенем	[['ледяной', {'дат,мн', 'твор,ед'}], ['пламень', {'твор,ед'}]]
ледяного раствора	[['ледяной', {'род,ед', 'вин,ед'}], ['раствор', {'род,ед'}]]
ледяную трещину	[['ледяной', {'вин,ед'}], ['трещина', {'вин,ед'}]]
ледяным склонам	[['ледяной', {'дат,мн', 'твор,ед'}], ['склон', {'дат,мн'}]]
ледяные громады	[['ледяной', {'вин,мн', 'им,мн'}], ['громада', {'вин,мн', 'род,ед', 'им,мн'}]]
ледяной язык	[['ледяной', {'твор,ед', 'пр,ед', 'дат,ед', 'им,ед', 'род,ед', 'вин,ед'}], ['язык', {'вин,ед', 'им,ед'}]]
ледяном охлаждении	[['ледяной', {'пр,ед'}], ['охлаждение', {'пр,ед'}]]
ледяным дождем	[['ледяной', {'дат,мн', 'твор,ед'}], ['дождь', {'твор,ед'}]]
ледяным плащом	[['ледяной', {'дат,мн', 'твор,ед'}], ['плащ', {'твор,ед'}]]
ледяные ядра	[['ледяной', {'вин,мн', 'им,мн'}], ['ядро', {'вин,мн', 'род,ед', 'им,мн'}]]
ледяную массу	[['ледяной', {'вин,ед'}], ['масса', {'вин,ед'}]]
ледяного озера	[['ледяной', {'род,ед', 'вин,ед'}], ['озеро', {'вин,мн', 'род,ед', 'им,мн'}]]
ледяные переправы	[['ледяной', {'вин,мн', 'им,мн'}], ['переправа', {'вин,мн', 'род,ед', 'им,мн'}]]
ледяной полосой	[['ледяной', {'твор,ед', 'пр,ед', 'дат,ед', 'им,ед', 'род,ед', 'вин,ед'}], ['полоса', {'твор,ед'}]]
ледяную гладь	[['ледяной', {'вин,ед'}], ['гладь', {'вин,ед', 'им,ед'}]]
ледяную стужу	[['ледяной', {'вин,ед'}], ['стужа', {'вин,ед'}]]
ледяной вал	[['ледяной', {'твор,ед', 'пр,ед', 'дат,ед', 'им,ед', 'род,ед', 'вин,ед'}], ['вал', {'вин,ед', 'им,ед'}]]
ледяной грот	[['ледяной', {'твор,ед', 'пр,ед', 'дат,ед', 'им,ед', 'род,ед', 'вин,ед'}], ['грот', {'вин,ед', 'им,ед'}]]
ледяные горошины	[['ледяной', {'вин,мн', 'им,мн'}], ['горошина', {'вин,мн', 'род,ед', 'им,мн'}]]
ледяное пиво	[['ледяной', {'вин,ед', 'им,ед'}], ['пиво', {'вин,ед', 'им,ед'}]]
ледяную струю	[['ледяной', {'вин,ед'}], ['струя', {'вин,ед'}]]
ледяном мешке	[['ледяной', {'пр,ед'}], ['мешок', {'пр,ед'}]]
ледяная ночь	[['ледяной', {'им,ед'}], ['ночь', {'вин,ед', 'им,ед'}]]
ледяной горы	[['ледяной', {'твор,ед', 'пр,ед', 'дат,ед', 'им,ед', 'род,ед', 'вин,ед'}], ['гора', {'вин,мн', 'род,ед', 'им,мн'}]]
ледяную кружку	[['ледяной', {'вин,ед'}], ['кружка', {'вин,ед'}]]
ледяной окрошкой	[['ледяной', {'твор,ед', 'пр,ед', 'дат,ед', 'им,ед', 'род,ед', 'вин,ед'}], ['окрошка', {'твор,ед'}]]
ледяные своды	[['ледяной', {'вин,мн', 'им,мн'}], ['свод', {'вин,мн', 'им,мн'}]]
ледяного вина	[['ледяной', {'род,ед', 'вин,ед'}], ['вино', {'вин,мн', 'род,ед', 'им,мн'}]]
ледяное дыханье	[['ледяной', {'вин,ед', 'им,ед'}], ['дыхание', {'пр,ед', 'вин,ед', 'им,ед'}]]
ледяному континенту	[['ледяной', {'дат,ед'}], ['континент', {'дат,ед'}]]
ледяной оболочкой	[['ледяной', {'твор,ед', 'пр,ед', 'дат,ед', 'им,ед', 'род,ед', 'вин,ед'}], ['оболочка', {'твор,ед'}]]
ледяные перевалы	[['ледяной', {'вин,мн', 'им,мн'}], ['перевал', {'вин,мн', 'им,мн'}]]
ледяную линзу	[['ледяной', {'вин,ед'}], ['линза', {'вин,ед'}]]
ледяной плотиной	[['ледяной', {'твор,ед', 'пр,ед', 'дат,ед', 'им,ед', 'род,ед', 'вин,ед'}], ['плотина', {'твор,ед'}]]
ледяная вьюга	[['ледяной', {'им,ед'}], ['вьюга', {'им,ед'}]]
ледяного кристалла	[['ледяной', {'род,ед', 'вин,ед'}], ['кристалл', {'род,ед'}]]
ледяная корочка	[['ледяной', {'им,ед'}], ['корочка', {'им,ед'}]]
ледяной путь	[['ледяной', {'твор,ед', 'пр,ед', 'дат,ед', 'им,ед', 'род,ед', 'вин,ед'}], ['путь', {'вин,ед', 'им,ед'}]]
ледяной площади	[['ледяной', {'твор,ед', 'пр,ед', 'дат,ед', 'им,ед', 'род,ед', 'вин,ед'}], ['площадь', {'вин,мн', 'дат,ед', 'пр,ед', 'род,ед', 'им,мн'}]]
ледяной комок	[['ледяной', {'твор,ед', 'пр,ед', 'дат,ед', 'им,ед', 'род,ед', 'вин,ед'}], ['комок', {'вин,ед', 'им,ед'}]]
ледяным глазам	[['ледяной', {'дат,мн', 'твор,ед'}], ['глаз', {'дат,мн'}]]
ледяную зону	[['ледяной', {'вин,ед'}], ['зона', {'вин,ед'}]]
ледяной смеси	[['ледяной', {'твор,ед', 'пр,ед', 'дат,ед', 'им,ед', 'род,ед', 'вин,ед'}], ['смесь', {'вин,мн', 'дат,ед', 'пр,ед', 'род,ед', 'им,мн'}]]
ледяным комом	[['ледяной', {'дат,мн', 'твор,ед'}], ['ком', {'твор,ед'}]]
ледяными валами	[['ледяной', {'твор,мн'}], ['вал', {'твор,мн'}]]
ледяной прибой	[['ледяной', {'твор,ед', 'пр,ед', 'дат,ед', 'им,ед', 'род,ед', 'вин,ед'}], ['прибой', {'вин,ед', 'им,ед'}]]
ледяного причала	[['ледяной', {'род,ед', 'вин,ед'}], ['причал', {'род,ед'}]]
ледяные поля	[['ледяной', {'вин,мн', 'им,мн'}], ['поле', {'вин,мн', 'род,ед', 'им,мн'}]]
ледяную грудь	[['ледяной', {'вин,ед'}], ['грудь', {'вин,ед', 'им,ед'}]]
ледяной скалы	[['ледяной', {'твор,ед', 'пр,ед', 'дат,ед', 'им,ед', 'род,ед', 'вин,ед'}], ['скала', {'вин,мн', 'род,ед', 'им,мн'}]]
ледяною холодностью	[['ледяной', {'твор,ед'}], ['холодность', {'твор,ед'}]]
ледяной нарост	[['ледяной', {'твор,ед', 'пр,ед', 'дат,ед', 'им,ед', 'род,ед', 'вин,ед'}], ['нарост', {'вин,ед', 'им,ед'}]]
ледяных пустынь	[['ледяной', {'пр,мн', 'род,мн', 'вин,мн'}], ['пустыня', {'род,мн'}]]
ледяном покое	[['ледяной', {'пр,ед'}], ['покой', {'пр,ед'}]]
ледяной стене	[['ледяной', {'твор,ед', 'пр,ед', 'дат,ед', 'им,ед', 'род,ед', 'вин,ед'}], ['стена', {'дат,ед', 'пр,ед'}]]
ледяном материке	[['ледяной', {'пр,ед'}], ['материк', {'пр,ед'}]]
ледяным кольцом	[['ледяной', {'дат,мн', 'твор,ед'}], ['кольцо', {'твор,ед'}]]
ледяным мраком	[['ледяной', {'дат,мн', 'твор,ед'}], ['мрак', {'твор,ед'}]]
ледяном полу	[['ледяной', {'пр,ед'}], ['пол', {'дат,ед', 'местн,ед'}]]
ледяными бородами	[['ледяной', {'твор,мн'}], ['борода', {'твор,мн'}]]
ледяной покой	[['ледяной', {'твор,ед', 'пр,ед', 'дат,ед', 'им,ед', 'род,ед', 'вин,ед'}], ['покой', {'вин,ед', 'им,ед'}]]
ледяными руками	[['ледяной', {'твор,мн'}], ['рука', {'твор,мн'}]]
ледяные ломтики	[['ледяной', {'вин,мн', 'им,мн'}], ['ломтик', {'вин,мн', 'им,мн'}]]
ледяной бани	[['ледяной', {'твор,ед', 'пр,ед', 'дат,ед', 'им,ед', 'род,ед', 'вин,ед'}], ['баня', {'вин,мн', 'род,ед', 'им,мн'}]]
ледяной части	[['ледяной', {'твор,ед', 'пр,ед', 'дат,ед', 'им,ед', 'род,ед', 'вин,ед'}], ['часть', {'вин,мн', 'дат,ед', 'пр,ед', 'род,ед', 'им,мн'}]]
ледяных объятиях	[['ледяной', {'пр,мн', 'род,мн', 'вин,мн'}], ['объятие', {'пр,мн'}]]
ледяных масс	[['ледяной', {'пр,мн', 'род,мн', 'вин,мн'}], ['масса', {'род,мн'}]]
ледяного основания	[['ледяной', {'род,ед', 'вин,ед'}], ['основание', {'вин,мн', 'род,ед', 'им,мн'}]]
ледяного презрения	[['ледяной', {'род,ед', 'вин,ед'}], ['презрение', {'вин,мн', 'род,ед', 'им,мн'}]]
ледяные сталактиты	[['ледяной', {'вин,мн', 'им,мн'}], ['сталактит', {'вин,мн', 'им,мн'}]]
ледяной комочек	[['ледяной', {'твор,ед', 'пр,ед', 'дат,ед', 'им,ед', 'род,ед', 'вин,ед'}], ['комочек', {'вин,ед', 'им,ед'}]]
ледяные слои	[['ледяной', {'вин,мн', 'им,мн'}], ['слой', {'вин,мн', 'им,мн'}]]
ледяных туманов	[['ледяной', {'пр,мн', 'род,мн', 'вин,мн'}], ['туман', {'род,мн'}]]
ледяному спуску	[['ледяной', {'дат,ед'}], ['спуск', {'дат,ед'}]]
ледяных шаров	[['ледяной', {'пр,мн', 'род,мн', 'вин,мн'}], ['шар', {'род,мн'}]]
ледяном одиночестве	[['ледяной', {'пр,ед'}], ['одиночество', {'пр,ед'}]]
ледяном огне	[['ледяной', {'пр,ед'}], ['огонь', {'пр,ед'}]]
ледяной покровы	[['ледяной', {'твор,ед', 'пр,ед', 'дат,ед', 'им,ед', 'род,ед', 'вин,ед'}], ['покров', {'вин,мн', 'им,мн'}]]
ледяной стеной	[['ледяной', {'твор,ед', 'пр,ед', 'дат,ед', 'им,ед', 'род,ед', 'вин,ед'}], ['стена', {'твор,ед'}]]
ледяной маской	[['ледяной', {'твор,ед', 'пр,ед', 'дат,ед', 'им,ед', 'род,ед', 'вин,ед'}], ['маска', {'твор,ед'}]]
ледяными островами	[['ледяной', {'твор,мн'}], ['остров', {'твор,мн'}]]
ледяной блеск	[['ледяной', {'твор,ед', 'пр,ед', 'дат,ед', 'им,ед', 'род,ед', 'вин,ед'}], ['блеск', {'вин,ед', 'им,ед'}]]
ледяным мостом	[['ледяной', {'дат,мн', 'твор,ед'}], ['мост', {'твор,ед'}]]
ледяная могила	[['ледяной', {'им,ед'}], ['могила', {'им,ед'}]]
ледяную дорогу	[['ледяной', {'вин,ед'}], ['дорога', {'вин,ед'}]]
ледяную Неву	[['ледяной', {'вин,ед'}], ['нева', {'вин,ед'}]]
ледяные доспехи	[['ледяной', {'вин,мн', 'им,мн'}], ['доспехи', {'вин,мн', 'им,мн'}]]
ледяным мешком	[['ледяной', {'дат,мн', 'твор,ед'}], ['мешок', {'твор,ед'}]]
ледяная ненависть	[['ледяной', {'им,ед'}], ['ненависть', {'вин,ед', 'им,ед'}]]
ледяных поля	[['ледяной', {'пр,мн', 'род,мн', 'вин,мн'}], ['поля', {'им,ед'}]]
ледяные ладони	[['ледяной', {'вин,мн', 'им,мн'}], ['ладонь', {'вин,мн', 'дат,ед', 'пр,ед', 'род,ед', 'им,мн'}]]
ледяного сала	[['ледяной', {'род,ед', 'вин,ед'}], ['сало', {'вин,мн', 'род,ед', 'им,мн'}]]
ледяной струйкой	[['ледяной', {'твор,ед', 'пр,ед', 'дат,ед', 'им,ед', 'род,ед', 'вин,ед'}], ['струйка', {'твор,ед'}]]
ледяные валуны	[['ледяной', {'вин,мн', 'им,мн'}], ['валун', {'вин,мн', 'им,мн'}]]
ледяного металла	[['ледяной', {'род,ед', 'вин,ед'}], ['металл', {'род,ед'}]]
ледяную крепость	[['ледяной', {'вин,ед'}], ['крепость', {'вин,ед', 'им,ед'}]]
ледяными обручами	[['ледяной', {'твор,мн'}], ['обруч', {'твор,мн'}]]
ледяной торос	[['ледяной', {'твор,ед', 'пр,ед', 'дат,ед', 'им,ед', 'род,ед', 'вин,ед'}], ['торос', {'вин,ед', 'им,ед'}]]
ледяных блоков	[['ледяной', {'пр,мн', 'род,мн', 'вин,мн'}], ['блок', {'род,мн'}]]
ледяной домик	[['ледяной', {'твор,ед', 'пр,ед', 'дат,ед', 'им,ед', 'род,ед', 'вин,ед'}], ['домик', {'вин,ед', 'им,ед'}]]
ледяное пространство	[['ледяной', {'вин,ед', 'им,ед'}], ['пространство', {'вин,ед', 'им,ед'}]]
ледяной вежливостью	[['ледяной', {'твор,ед', 'пр,ед', 'дат,ед', 'им,ед', 'род,ед', 'вин,ед'}], ['вежливость', {'твор,ед'}]]
ледяные шарики	[['ледяной', {'вин,мн', 'им,мн'}], ['шарик', {'вин,мн', 'им,мн'}]]
ледяном Ворон	[['ледяной', {'пр,ед'}], ['ворон', {'им,ед'}]]
ледяной нагрузки	[['ледяной', {'твор,ед', 'пр,ед', 'дат,ед', 'им,ед', 'род,ед', 'вин,ед'}], ['нагрузка', {'вин,мн', 'род,ед', 'им,мн'}]]
ледяной переправе	[['ледяной', {'твор,ед', 'пр,ед', 'дат,ед', 'им,ед', 'род,ед', 'вин,ед'}], ['переправа', {'дат,ед', 'пр,ед'}]]
ледяной волной	[['ледяной', {'твор,ед', 'пр,ед', 'дат,ед', 'им,ед', 'род,ед', 'вин,ед'}], ['волна', {'твор,ед'}]]
ледяным дыханьем	[['ледяной', {'дат,мн', 'твор,ед'}], ['дыхание', {'твор,ед'}]]
ледяные зубцы	[['ледяной', {'вин,мн', 'им,мн'}], ['зубец', {'вин,мн', 'им,мн'}]]
ледяные искры	[['ледяной', {'вин,мн', 'им,мн'}], ['искра', {'вин,мн', 'род,ед', 'им,мн'}]]
ледяную тишину	[['ледяной', {'вин,ед'}], ['тишина', {'вин,ед'}]]
ледяные кристаллики	[['ледяной', {'вин,мн', 'им,мн'}], ['кристаллик', {'вин,мн', 'им,мн'}]]
ледяному дому	[['ледяной', {'дат,ед'}], ['дом', {'дат,ед', 'парт,ед', 'местн,ед'}]]
ледяной пыли	[['ледяной', {'твор,ед', 'пр,ед', 'дат,ед', 'им,ед', 'род,ед', 'вин,ед'}], ['пыль', {'вин,мн', 'дат,ед', 'пр,ед', 'род,ед', 'им,мн'}]]
ледяной горе	[['ледяной', {'твор,ед', 'пр,ед', 'дат,ед', 'им,ед', 'род,ед', 'вин,ед'}], ['гора', {'дат,ед', 'пр,ед'}]]
ледяная вершина	[['ледяной', {'им,ед'}], ['вершина', {'им,ед'}]]
ледяною рукою	[['ледяной', {'твор,ед'}], ['рука', {'твор,ед'}]]
ледяного моста	[['ледяной', {'род,ед', 'вин,ед'}], ['мост', {'род,ед'}]]
ледяном вихре	[['ледяной', {'пр,ед'}], ['вихор', {'пр,ед'}]]
ледяных образований	[['ледяной', {'пр,мн', 'род,мн', 'вин,мн'}], ['образование', {'род,мн'}]]
ледяные ночи	[['ледяной', {'вин,мн', 'им,мн'}], ['ночь', {'вин,мн', 'местн,ед', 'пр,ед', 'им,мн', 'дат,ед', 'род,ед'}]]
ледяных гор	[['ледяной', {'пр,мн', 'род,мн', 'вин,мн'}], ['гора', {'род,мн'}]]
ледяной ладонью	[['ледяной', {'твор,ед', 'пр,ед', 'дат,ед', 'им,ед', 'род,ед', 'вин,ед'}], ['ладонь', {'твор,ед'}]]
ледяные бугры	[['ледяной', {'вин,мн', 'им,мн'}], ['бугор', {'вин,мн', 'им,мн'}]]
ледяном плато	[['ледяной', {'пр,ед'}], ['плато', {'род,мн', 'твор,ед', 'вин,мн', 'пр,ед', 'им,мн', 'дат,ед', 'им,ед', 'твор,мн', 'род,ед', 'вин,ед', 'пр,мн', 'дат,мн'}]]
ледяной шар	[['ледяной', {'твор,ед', 'пр,ед', 'дат,ед', 'им,ед', 'род,ед', 'вин,ед'}], ['шар', {'вин,ед', 'им,ед'}]]
ледяной тишины	[['ледяной', {'твор,ед', 'пр,ед', 'дат,ед', 'им,ед', 'род,ед', 'вин,ед'}], ['тишина', {'род,ед'}]]
ледяной ответ	[['ледяной', {'твор,ед', 'пр,ед', 'дат,ед', 'им,ед', 'род,ед', 'вин,ед'}], ['ответ', {'вин,ед', 'им,ед'}]]
ледяных вод	[['ледяной', {'пр,мн', 'род,мн', 'вин,мн'}], ['вода', {'род,мн'}]]
ледяные зерна	[['ледяной', {'вин,мн', 'им,мн'}], ['зерно', {'вин,мн', 'род,ед', 'им,мн'}]]
ледяным сердцем	[['ледяной', {'дат,мн', 'твор,ед'}], ['сердце', {'твор,ед'}]]
ледяные города	[['ледяной', {'вин,мн', 'им,мн'}], ['город', {'вин,мн', 'род,ед', 'им,мн'}]]
ледяных ветрах	[['ледяной', {'пр,мн', 'род,мн', 'вин,мн'}], ['ветер', {'пр,мн'}]]
ледяных пещер	[['ледяной', {'пр,мн', 'род,мн', 'вин,мн'}], ['пещера', {'род,мн'}]]
ледяною корой	[['ледяной', {'твор,ед'}], ['кора', {'твор,ед'}]]
ледяном гробу	[['ледяной', {'пр,ед'}], ['гроб', {'дат,ед', 'местн,ед'}]]
ледяной постели	[['ледяной', {'твор,ед', 'пр,ед', 'дат,ед', 'им,ед', 'род,ед', 'вин,ед'}], ['постель', {'вин,мн', 'дат,ед', 'пр,ед', 'род,ед', 'им,мн'}]]
ледяной степи	[['ледяной', {'твор,ед', 'пр,ед', 'дат,ед', 'им,ед', 'род,ед', 'вин,ед'}], ['степь', {'вин,мн', 'дат,ед', 'пр,ед', 'род,ед', 'им,мн'}]]
ледяной жиже	[['ледяной', {'твор,ед', 'пр,ед', 'дат,ед', 'им,ед', 'род,ед', 'вин,ед'}], ['жижа', {'дат,ед', 'пр,ед'}]]
ледяные нагромождения	[['ледяной', {'вин,мн', 'им,мн'}], ['нагромождение', {'вин,мн', 'род,ед', 'им,мн'}]]
ледяной яме	[['ледяной', {'твор,ед', 'пр,ед', 'дат,ед', 'им,ед', 'род,ед', 'вин,ед'}], ['яма', {'дат,ед', 'пр,ед'}]]
ледяные вершины	[['ледяной', {'вин,мн', 'им,мн'}], ['вершина', {'вин,мн', 'род,ед', 'им,мн'}]]
ледяными вершинами	[['ледяной', {'твор,мн'}], ['вершина', {'твор,мн'}]]
ледяной лоб	[['ледяной', {'твор,ед', 'пр,ед', 'дат,ед', 'им,ед', 'род,ед', 'вин,ед'}], ['лоб', {'вин,ед', 'им,ед'}]]
ледяной горки	[['ледяной', {'твор,ед', 'пр,ед', 'дат,ед', 'им,ед', 'род,ед', 'вин,ед'}], ['горка', {'вин,мн', 'род,ед', 'им,мн'}]]
ледяную скалу	[['ледяной', {'вин,ед'}], ['скала', {'вин,ед'}]]
ледяной сон	[['ледяной', {'твор,ед', 'пр,ед', 'дат,ед', 'им,ед', 'род,ед', 'вин,ед'}], ['сон', {'вин,ед', 'им,ед'}]]
ледяного клина	[['ледяной', {'род,ед', 'вин,ед'}], ['клин', {'род,ед'}]]
ледяную броню	[['ледяной', {'вин,ед'}], ['броня', {'вин,ед'}]]
ледяных площадках	[['ледяной', {'пр,мн', 'род,мн', 'вин,мн'}], ['площадка', {'пр,мн'}]]
ледяных покровах	[['ледяной', {'пр,мн', 'род,мн', 'вин,мн'}], ['покров', {'пр,мн'}]]
ледяной взгляд	[['ледяной', {'твор,ед', 'пр,ед', 'дат,ед', 'им,ед', 'род,ед', 'вин,ед'}], ['взгляд', {'вин,ед', 'им,ед'}]]
ледяные объятья	[['ледяной', {'вин,мн', 'им,мн'}], ['объятие', {'вин,мн', 'род,ед', 'им,мн'}]]
ледяного ската	[['ледяной', {'род,ед', 'вин,ед'}], ['скат', {'род,ед'}]]
ледяной материк	[['ледяной', {'твор,ед', 'пр,ед', 'дат,ед', 'им,ед', 'род,ед', 'вин,ед'}], ['материк', {'вин,ед', 'им,ед'}]]
ледяной квартире	[['ледяной', {'твор,ед', 'пр,ед', 'дат,ед', 'им,ед', 'род,ед', 'вин,ед'}], ['квартира', {'дат,ед', 'пр,ед'}]]
ледяное зеркало	[['ледяной', {'вин,ед', 'им,ед'}], ['зеркало', {'вин,ед', 'им,ед'}]]
ледяном зале	[['ледяной', {'пр,ед'}], ['зал', {'пр,ед'}]]
ледяной карцер	[['ледяной', {'твор,ед', 'пр,ед', 'дат,ед', 'им,ед', 'род,ед', 'вин,ед'}], ['карцер', {'вин,ед', 'им,ед'}]]
ледяной сосулькой	[['ледяной', {'твор,ед', 'пр,ед', 'дат,ед', 'им,ед', 'род,ед', 'вин,ед'}], ['сосулька', {'твор,ед'}]]
ледяного городка	[['ледяной', {'род,ед', 'вин,ед'}], ['городок', {'род,ед'}]]
ледяных равнин	[['ледяной', {'пр,мн', 'род,мн', 'вин,мн'}], ['равнина', {'род,мн'}]]
ледяном рассоле	[['ледяной', {'пр,ед'}], ['рассол', {'пр,ед'}]]
ледяную землю	[['ледяной', {'вин,ед'}], ['земля', {'вин,ед'}]]
ледяным адом	[['ледяной', {'дат,мн', 'твор,ед'}], ['ад', {'твор,ед'}]]
ледяные тиски	[['ледяной', {'вин,мн', 'им,мн'}], ['тиски', {'вин,мн', 'им,мн'}]]
ледяным пластом	[['ледяной', {'дат,мн', 'твор,ед'}], ['пласт', {'твор,ед'}]]
ледяную кольчугу	[['ледяной', {'вин,ед'}], ['кольчуга', {'вин,ед'}]]
ледяного покоя	[['ледяной', {'род,ед', 'вин,ед'}], ['покой', {'род,ед'}]]
ледяных скал	[['ледяной', {'пр,мн', 'род,мн', 'вин,мн'}], ['скала', {'род,мн'}]]
ледяных клиньев	[['ледяной', {'пр,мн', 'род,мн', 'вин,мн'}], ['клин', {'род,мн'}]]
ледяная плита	[['ледяной', {'им,ед'}], ['плита', {'им,ед'}]]
ледяному спокойствию	[['ледяной', {'дат,ед'}], ['спокойствие', {'дат,ед'}]]
ледяной град	[['ледяной', {'твор,ед', 'пр,ед', 'дат,ед', 'им,ед', 'род,ед', 'вин,ед'}], ['град', {'вин,ед', 'им,ед'}]]
ледяным полем	[['ледяной', {'дат,мн', 'твор,ед'}], ['поле', {'твор,ед'}]]
ледяной тон	[['ледяной', {'твор,ед', 'пр,ед', 'дат,ед', 'им,ед', 'род,ед', 'вин,ед'}], ['тон', {'вин,ед', 'им,ед'}]]
ледяной СНзСООН	[['ледяной', {'твор,ед', 'пр,ед', 'дат,ед', 'им,ед', 'род,ед', 'вин,ед'}], ['снзсоон', {'им,ед'}]]
ледяным голосом	[['ледяной', {'дат,мн', 'твор,ед'}], ['голос', {'твор,ед'}]]
ледяное дуновение	[['ледяной', {'вин,ед', 'им,ед'}], ['дуновение', {'вин,ед', 'им,ед'}]]
ледяную влагу	[['ледяной', {'вин,ед'}], ['влага', {'вин,ед'}]]
ледяным плато	[['ледяной', {'дат,мн', 'твор,ед'}], ['плато', {'род,мн', 'твор,ед', 'вин,мн', 'пр,ед', 'им,мн', 'дат,ед', 'им,ед', 'твор,мн', 'род,ед', 'вин,ед', 'пр,мн', 'дат,мн'}]]
ледяному дыханию	[['ледяной', {'дат,ед'}], ['дыхание', {'дат,ед'}]]
ледяную площадку	[['ледяной', {'вин,ед'}], ['площадка', {'вин,ед'}]]
ледяной сумрак	[['ледяной', {'твор,ед', 'пр,ед', 'дат,ед', 'им,ед', 'род,ед', 'вин,ед'}], ['сумрак', {'вин,ед', 'им,ед'}]]
ледяной панцырь	[['ледяной', {'твор,ед', 'пр,ед', 'дат,ед', 'им,ед', 'род,ед', 'вин,ед'}], ['панцырь', {'вин,ед', 'им,ед'}]]
ледяной броней	[['ледяной', {'твор,ед', 'пр,ед', 'дат,ед', 'им,ед', 'род,ед', 'вин,ед'}], ['броня', {'род,мн', 'твор,ед'}]]
ледяные керны	[['ледяной', {'вин,мн', 'им,мн'}], ['керн', {'вин,мн', 'им,мн'}]]
ледяном коридоре	[['ледяной', {'пр,ед'}], ['коридор', {'пр,ед'}]]
ледяная кровь	[['ледяной', {'им,ед'}], ['кровь', {'вин,ед', 'им,ед'}]]
ледяных причалов	[['ледяной', {'пр,мн', 'род,мн', 'вин,мн'}], ['причал', {'род,мн'}]]
ледяном тумане	[['ледяной', {'пр,ед'}], ['туман', {'пр,ед'}]]
ледяной поцелуй	[['ледяной', {'твор,ед', 'пр,ед', 'дат,ед', 'им,ед', 'род,ед', 'вин,ед'}], ['поцелуй', {'вин,ед', 'им,ед'}]]
ледяной пещерой	[['ледяной', {'твор,ед', 'пр,ед', 'дат,ед', 'им,ед', 'род,ед', 'вин,ед'}], ['пещера', {'твор,ед'}]]
ледяному откосу	[['ледяной', {'дат,ед'}], ['откос', {'дат,ед'}]]
ледяное лицо	[['ледяной', {'вин,ед', 'им,ед'}], ['лицо', {'вин,ед', 'им,ед'}]]
ледяному сердцу	[['ледяной', {'дат,ед'}], ['сердце', {'дат,ед'}]]
ледяных заторах	[['ледяной', {'пр,мн', 'род,мн', 'вин,мн'}], ['затор', {'пр,мн'}]]
ледяную дыру	[['ледяной', {'вин,ед'}], ['дыра', {'вин,ед'}]]
ледяных мостов	[['ледяной', {'пр,мн', 'род,мн', 'вин,мн'}], ['мост', {'род,мн'}]]
ледяной невозмутимостью	[['ледяной', {'твор,ед', 'пр,ед', 'дат,ед', 'им,ед', 'род,ед', 'вин,ед'}], ['невозмутимость', {'твор,ед'}]]
ледяной кромкой	[['ледяной', {'твор,ед', 'пр,ед', 'дат,ед', 'им,ед', 'род,ед', 'вин,ед'}], ['кромка', {'твор,ед'}]]
ледяным тоном	[['ледяной', {'дат,мн', 'твор,ед'}], ['тон', {'твор,ед'}]]
ледяных сосульках	[['ледяной', {'пр,мн', 'род,мн', 'вин,мн'}], ['сосулька', {'пр,мн'}]]
ледяным шампанским	[['ледяной', {'дат,мн', 'твор,ед'}], ['шампанское', {'дат,мн', 'твор,ед'}]]
ледяными заторами	[['ледяной', {'твор,мн'}], ['затор', {'твор,мн'}]]
ледяные покровы	[['ледяной', {'вин,мн', 'им,мн'}], ['покров', {'вин,мн', 'им,мн'}]]
ледяную глубину	[['ледяной', {'вин,ед'}], ['глубина', {'вин,ед'}]]
ледяной восторг	[['ледяной', {'твор,ед', 'пр,ед', 'дат,ед', 'им,ед', 'род,ед', 'вин,ед'}], ['восторг', {'вин,ед', 'им,ед'}]]
ледяного питания	[['ледяной', {'род,ед', 'вин,ед'}], ['питание', {'вин,мн', 'род,ед', 'им,мн'}]]
ледяным дворцом	[['ледяной', {'дат,мн', 'твор,ед'}], ['дворец', {'твор,ед'}]]
ледяной смесью	[['ледяной', {'твор,ед', 'пр,ед', 'дат,ед', 'им,ед', 'род,ед', 'вин,ед'}], ['смесь', {'твор,ед'}]]
ледяная улыбка	[['ледяной', {'им,ед'}], ['улыбка', {'им,ед'}]]
ледяной мрак	[['ледяной', {'твор,ед', 'пр,ед', 'дат,ед', 'им,ед', 'род,ед', 'вин,ед'}], ['мрак', {'вин,ед', 'им,ед'}]]
ледяной дрожи	[['ледяной', {'твор,ед', 'пр,ед', 'дат,ед', 'им,ед', 'род,ед', 'вин,ед'}], ['дрожь', {'вин,мн', 'дат,ед', 'пр,ед', 'род,ед', 'им,мн'}]]
ледяной пот	[['ледяной', {'твор,ед', 'пр,ед', 'дат,ед', 'им,ед', 'род,ед', 'вин,ед'}], ['пот', {'вин,ед', 'им,ед'}]]
ледяного тона	[['ледяной', {'род,ед', 'вин,ед'}], ['тон', {'вин,мн', 'род,ед', 'им,мн'}]]
ледяные карнизы	[['ледяной', {'вин,мн', 'им,мн'}], ['карниз', {'вин,мн', 'им,мн'}]]
ледяному кругу	[['ледяной', {'дат,ед'}], ['круг', {'дат,ед', 'местн,ед'}]]
ледяной росой	[['ледяной', {'твор,ед', 'пр,ед', 'дат,ед', 'им,ед', 'род,ед', 'вин,ед'}], ['роса', {'твор,ед'}]]
ледяной лимонад	[['ледяной', {'твор,ед', 'пр,ед', 'дат,ед', 'им,ед', 'род,ед', 'вин,ед'}], ['лимонад', {'вин,ед', 'им,ед'}]]
ледяными кристаллами	[['ледяной', {'твор,мн'}], ['кристалл', {'твор,мн'}]]
ледяным буграм	[['ледяной', {'дат,мн', 'твор,ед'}], ['бугор', {'дат,мн'}]]
ледяные их	[['ледяной', {'вин,мн', 'им,мн'}], ['они', {'род,мн', 'вин,мн'}]]
ледяными стенами	[['ледяной', {'твор,мн'}], ['стена', {'твор,мн'}]]
ледяные шары	[['ледяной', {'вин,мн', 'им,мн'}], ['шар', {'вин,мн', 'им,мн'}]]
ледяном складе	[['ледяной', {'пр,ед'}], ['склад', {'пр,ед'}]]
ледяному пространству	[['ледяной', {'дат,ед'}], ['пространство', {'дат,ед'}]]
ледяной дороге	[['ледяной', {'твор,ед', 'пр,ед', 'дат,ед', 'им,ед', 'род,ед', 'вин,ед'}], ['дорога', {'дат,ед', 'пр,ед'}]]
ледяных плит	[['ледяной', {'пр,мн', 'род,мн', 'вин,мн'}], ['плита', {'род,мн'}]]
ледяною Безмолвие	[['ледяной', {'твор,ед'}], ['безмолвие', {'вин,ед', 'им,ед'}]]
ледяного слона	[['ледяной', {'род,ед', 'вин,ед'}], ['слон', {'род,ед', 'вин,ед'}]]
ледяному материку	[['ледяной', {'дат,ед'}], ['материк', {'дат,ед'}]]
ледяных рек	[['ледяной', {'пр,мн', 'род,мн', 'вин,мн'}], ['река', {'род,мн'}]]
ледяным вихрем	[['ледяной', {'дат,мн', 'твор,ед'}], ['вихорь', {'твор,ед'}]]
ледяными ладонями	[['ледяной', {'твор,мн'}], ['ладонь', {'твор,мн'}]]
ледяные пики	[['ледяной', {'вин,мн', 'им,мн'}], ['пика', {'вин,мн', 'род,ед', 'им,мн'}]]
ледяной плен	[['ледяной', {'твор,ед', 'пр,ед', 'дат,ед', 'им,ед', 'род,ед', 'вин,ед'}], ['плен', {'вин,ед', 'им,ед'}]]
ледяные окна	[['ледяной', {'вин,мн', 'им,мн'}], ['окно', {'вин,мн', 'род,ед', 'им,мн'}]]
ледяном панцире	[['ледяной', {'пр,ед'}], ['панцирь', {'пр,ед'}]]
ледяные души	[['ледяной', {'вин,мн', 'им,мн'}], ['душа', {'вин,мн', 'род,ед', 'им,мн'}]]
ледяной речке	[['ледяной', {'твор,ед', 'пр,ед', 'дат,ед', 'им,ед', 'род,ед', 'вин,ед'}], ['речка', {'дат,ед', 'пр,ед'}]]
ледяной тундры	[['ледяной', {'твор,ед', 'пр,ед', 'дат,ед', 'им,ед', 'род,ед', 'вин,ед'}], ['тундра', {'вин,мн', 'род,ед', 'им,мн'}]]
ледяная тюрьма	[['ледяной', {'им,ед'}], ['тюрьма', {'им,ед'}]]
ледяную пыль	[['ледяной', {'вин,ед'}], ['пыль', {'вин,ед', 'им,ед'}]]
ледяного хребта	[['ледяной', {'род,ед', 'вин,ед'}], ['хребет', {'род,ед'}]]
ледяной сферы	[['ледяной', {'твор,ед', 'пр,ед', 'дат,ед', 'им,ед', 'род,ед', 'вин,ед'}], ['сфера', {'вин,мн', 'род,ед', 'им,мн'}]]
ледяной модели	[['ледяной', {'твор,ед', 'пр,ед', 'дат,ед', 'им,ед', 'род,ед', 'вин,ед'}], ['модель', {'вин,мн', 'дат,ед', 'пр,ед', 'род,ед', 'им,мн'}]]
ледяной ужас	[['ледяной', {'твор,ед', 'пр,ед', 'дат,ед', 'им,ед', 'род,ед', 'вин,ед'}], ['ужас', {'вин,ед', 'им,ед'}]]
ледяной неподвижности	[['ледяной', {'твор,ед', 'пр,ед', 'дат,ед', 'им,ед', 'род,ед', 'вин,ед'}], ['неподвижность', {'вин,мн', 'дат,ед', 'пр,ед', 'род,ед', 'им,мн'}]]
ледяной аэродром	[['ледяной', {'твор,ед', 'пр,ед', 'дат,ед', 'им,ед', 'род,ед', 'вин,ед'}], ['аэродром', {'вин,ед', 'им,ед'}]]
ледяном домике	[['ледяной', {'пр,ед'}], ['домик', {'пр,ед'}]]
ледяных штормов	[['ледяной', {'пр,мн', 'род,мн', 'вин,мн'}], ['шторм', {'род,мн'}]]
ледяная игла	[['ледяной', {'им,ед'}], ['игла', {'им,ед'}]]
ледяного материка	[['ледяной', {'род,ед', 'вин,ед'}], ['материк', {'род,ед'}]]
ледяная равнина	[['ледяной', {'им,ед'}], ['равнина', {'им,ед'}]]
ледяной паркет	[['ледяной', {'твор,ед', 'пр,ед', 'дат,ед', 'им,ед', 'род,ед', 'вин,ед'}], ['паркет', {'вин,ед', 'им,ед'}]]
ледяными струйками	[['ледяной', {'твор,мн'}], ['струйка', {'твор,мн'}]]
ледяной круче	[['ледяной', {'твор,ед', 'пр,ед', 'дат,ед', 'им,ед', 'род,ед', 'вин,ед'}], ['крутой', set()]]
ледяного сна	[['ледяной', {'род,ед', 'вин,ед'}], ['сон', {'род,ед'}]]
ледяной слой	[['ледяной', {'твор,ед', 'пр,ед', 'дат,ед', 'им,ед', 'род,ед', 'вин,ед'}], ['слой', {'вин,ед', 'им,ед'}]]
ледяных цветов	[['ледяной', {'пр,мн', 'род,мн', 'вин,мн'}], ['цветок', {'род,мн'}]]
ледяные пластины	[['ледяной', {'вин,мн', 'им,мн'}], ['пластина', {'вин,мн', 'род,ед', 'им,мн'}]]
ледяные кручи	[['ледяной', {'вин,мн', 'им,мн'}], ['круча', {'вин,мн', 'род,ед', 'им,мн'}]]
ледяной усмешкой	[['ледяной', {'твор,ед', 'пр,ед', 'дат,ед', 'им,ед', 'род,ед', 'вин,ед'}], ['усмешка', {'твор,ед'}]]
ледяного шампанского	[['ледяной', {'род,ед', 'вин,ед'}], ['шампанское', {'род,ед'}]]
ледяной калориметр	[['ледяной', {'твор,ед', 'пр,ед', 'дат,ед', 'им,ед', 'род,ед', 'вин,ед'}], ['калориметр', {'вин,ед', 'им,ед'}]]
ледяной земле	[['ледяной', {'твор,ед', 'пр,ед', 'дат,ед', 'им,ед', 'род,ед', 'вин,ед'}], ['земля', {'дат,ед', 'пр,ед'}]]
ледяной полынье	[['ледяной', {'твор,ед', 'пр,ед', 'дат,ед', 'им,ед', 'род,ед', 'вин,ед'}], ['полынья', {'дат,ед', 'пр,ед'}]]
ледяные слезы	[['ледяной', {'вин,мн', 'им,мн'}], ['слеза', {'вин,мн', 'род,ед', 'им,мн'}]]
ледяные мосты	[['ледяной', {'вин,мн', 'им,мн'}], ['мост', {'вин,мн', 'им,мн'}]]
ледяного тела	[['ледяной', {'род,ед', 'вин,ед'}], ['тело', {'вин,мн', 'род,ед', 'им,мн'}]]
ледяных игл	[['ледяной', {'пр,мн', 'род,мн', 'вин,мн'}], ['игла', {'род,мн'}]]
ледяной январь	[['ледяной', {'твор,ед', 'пр,ед', 'дат,ед', 'им,ед', 'род,ед', 'вин,ед'}], ['январь', {'вин,ед', 'им,ед'}]]
ледяные напитки	[['ледяной', {'вин,мн', 'им,мн'}], ['напиток', {'вин,мн', 'им,мн'}]]
ледяной руки	[['ледяной', {'твор,ед', 'пр,ед', 'дат,ед', 'им,ед', 'род,ед', 'вин,ед'}], ['рука', {'вин,мн', 'род,ед', 'им,мн'}]]
ледяная перемычка	[['ледяной', {'им,ед'}], ['перемычка', {'им,ед'}]]
ледяном куполе	[['ледяной', {'пр,ед'}], ['купол', {'пр,ед'}]]
ледяным барьером	[['ледяной', {'дат,мн', 'твор,ед'}], ['барьер', {'твор,ед'}]]
ледяную шугу	[['ледяной', {'вин,ед'}], ['шуга', {'вин,ед'}]]
ледяной хаос	[['ледяной', {'твор,ед', 'пр,ед', 'дат,ед', 'им,ед', 'род,ед', 'вин,ед'}], ['хаос', {'вин,ед', 'им,ед'}]]
ледяные частицы	[['ледяной', {'вин,мн', 'им,мн'}], ['частица', {'вин,мн', 'род,ед', 'им,мн'}]]
ледяные главы	[['ледяной', {'вин,мн', 'им,мн'}], ['глава', {'вин,мн', 'род,ед', 'им,мн'}]]
ледяную мглу	[['ледяной', {'вин,ед'}], ['мгла', {'вин,ед'}]]
ледяной эпохи	[['ледяной', {'твор,ед', 'пр,ед', 'дат,ед', 'им,ед', 'род,ед', 'вин,ед'}], ['эпоха', {'вин,мн', 'род,ед', 'им,мн'}]]
ледяных потоках	[['ледяной', {'пр,мн', 'род,мн', 'вин,мн'}], ['поток', {'пр,мн'}]]
ледяную одежду	[['ледяной', {'вин,ед'}], ['одежда', {'вин,ед'}]]
ледяное основание	[['ледяной', {'вин,ед', 'им,ед'}], ['основание', {'вин,ед', 'им,ед'}]]
ледяные кристаллы	[['ледяной', {'вин,мн', 'им,мн'}], ['кристалл', {'вин,мн', 'им,мн'}]]
ледяного оцепенения	[['ледяной', {'род,ед', 'вин,ед'}], ['оцепенение', {'вин,мн', 'род,ед', 'им,мн'}]]
ледяных тисках	[['ледяной', {'пр,мн', 'род,мн', 'вин,мн'}], ['тиски', {'пр,мн'}]]
ледяную свечку	[['ледяной', {'вин,ед'}], ['свечка', {'вин,ед'}]]
ледяным туманом	[['ледяной', {'дат,мн', 'твор,ед'}], ['туман', {'твор,ед'}]]
ледяных иголочек	[['ледяной', {'пр,мн', 'род,мн', 'вин,мн'}], ['иголочка', {'род,мн'}]]
ледяная плотина	[['ледяной', {'им,ед'}], ['плотина', {'им,ед'}]]
ледяной ловушке	[['ледяной', {'твор,ед', 'пр,ед', 'дат,ед', 'им,ед', 'род,ед', 'вин,ед'}], ['ловушка', {'дат,ед', 'пр,ед'}]]
ледяного похода	[['ледяной', {'род,ед', 'вин,ед'}], ['поход', {'род,ед'}]]
ледяной луже	[['ледяной', {'твор,ед', 'пр,ед', 'дат,ед', 'им,ед', 'род,ед', 'вин,ед'}], ['лужа', {'дат,ед', 'пр,ед'}]]
ледяную руку	[['ледяной', {'вин,ед'}], ['рука', {'вин,ед'}]]
ледяным взглядом	[['ледяной', {'дат,мн', 'твор,ед'}], ['взгляд', {'твор,ед'}]]
ледяное выражение	[['ледяной', {'вин,ед', 'им,ед'}], ['выражение', {'вин,ед', 'им,ед'}]]
ледяным сводом	[['ледяной', {'дат,мн', 'твор,ед'}], ['свод', {'твор,ед'}]]
ледяная лавина	[['ледяной', {'им,ед'}], ['лавина', {'им,ед'}]]
ледяных алмазах	[['ледяной', {'пр,мн', 'род,мн', 'вин,мн'}], ['алмаз', {'пр,мн'}]]
ледяным вершинам	[['ледяной', {'дат,мн', 'твор,ед'}], ['вершина', {'дат,мн'}]]
ледяные шлиры	[['ледяной', {'вин,мн', 'им,мн'}], ['шлир', {'вин,мн', 'им,мн'}]]
ледяная крупка	[['ледяной', {'им,ед'}], ['крупка', {'им,ед'}]]
ледяную крутизну	[['ледяной', {'вин,ед'}], ['крутизна', {'вин,ед'}]]
ледяным кристаллом	[['ледяной', {'дат,мн', 'твор,ед'}], ['кристалл', {'твор,ед'}]]
ледяном потоке	[['ледяной', {'пр,ед'}], ['поток', {'пр,ед'}]]
ледяные клинья	[['ледяной', {'вин,мн', 'им,мн'}], ['клин', {'вин,мн', 'им,мн'}]]
ледяное тело	[['ледяной', {'вин,ед', 'им,ед'}], ['тело', {'вин,ед', 'им,ед'}]]
ледяного затора	[['ледяной', {'род,ед', 'вин,ед'}], ['затор', {'род,ед'}]]
ледяного образца	[['ледяной', {'род,ед', 'вин,ед'}], ['образец', {'род,ед'}]]
ледяная масса	[['ледяной', {'им,ед'}], ['масса', {'им,ед'}]]
ледяных высотах	[['ледяной', {'пр,мн', 'род,мн', 'вин,мн'}], ['высота', {'пр,мн'}]]
ледяную трассу	[['ледяной', {'вин,ед'}], ['трасса', {'вин,ед'}]]
ледяная синева	[['ледяной', {'им,ед'}], ['синева', {'им,ед'}]]
ледяное оцепенение	[['ледяной', {'вин,ед', 'им,ед'}], ['оцепенение', {'вин,ед', 'им,ед'}]]
ледяной песок	[['ледяной', {'твор,ед', 'пр,ед', 'дат,ед', 'им,ед', 'род,ед', 'вин,ед'}], ['песок', {'вин,ед', 'им,ед'}]]
ледяных пространств	[['ледяной', {'пр,мн', 'род,мн', 'вин,мн'}], ['пространство', {'род,мн'}]]
ледяных потоков	[['ледяной', {'пр,мн', 'род,мн', 'вин,мн'}], ['поток', {'род,мн'}]]
ледяного периода	[['ледяной', {'род,ед', 'вин,ед'}], ['период', {'род,ед'}]]
ледяная звезда	[['ледяной', {'им,ед'}], ['звезда', {'им,ед'}]]
ледяными блестками	[['ледяной', {'твор,мн'}], ['блестка', {'твор,мн'}]]
ледяными пластинками	[['ледяной', {'твор,мн'}], ['пластинка', {'твор,мн'}]]
ледяных пород	[['ледяной', {'пр,мн', 'род,мн', 'вин,мн'}], ['порода', {'род,мн'}]]
ледяным крошевом	[['ледяной', {'дат,мн', 'твор,ед'}], ['крошево', {'твор,ед'}]]
ледяных кристалликах	[['ледяной', {'пр,мн', 'род,мн', 'вин,мн'}], ['кристаллик', {'пр,мн'}]]
ледяного мыса	[['ледяной', {'род,ед', 'вин,ед'}], ['мыс', {'род,ед'}]]
ледяного шара	[['ледяной', {'род,ед', 'вин,ед'}], ['шар', {'род,ед'}]]
ледяным торосам	[['ледяной', {'дат,мн', 'твор,ед'}], ['торос', {'дат,мн'}]]
ледяных дамб	[['ледяной', {'пр,мн', 'род,мн', 'вин,мн'}], ['дамба', {'род,мн'}]]
ледяными мурашками	[['ледяной', {'твор,мн'}], ['мурашка', {'твор,мн'}]]
ледяные склоны	[['ледяной', {'вин,мн', 'им,мн'}], ['склон', {'вин,мн', 'им,мн'}]]
ледяные оковы	[['ледяной', {'вин,мн', 'им,мн'}], ['оковы', {'вин,мн', 'им,мн'}]]
ледяных куполах	[['ледяной', {'пр,мн', 'род,мн', 'вин,мн'}], ['купол', {'пр,мн'}]]
ледяной материал	[['ледяной', {'твор,ед', 'пр,ед', 'дат,ед', 'им,ед', 'род,ед', 'вин,ед'}], ['материал', {'вин,ед', 'им,ед'}]]
ледяное поднебесье	[['ледяной', {'вин,ед', 'им,ед'}], ['поднебесье', {'пр,ед', 'вин,ед', 'им,ед'}]]
ледяное русло	[['ледяной', {'вин,ед', 'им,ед'}], ['русло', {'вин,ед', 'им,ед'}]]
ледяным простором	[['ледяной', {'дат,мн', 'твор,ед'}], ['простор', {'твор,ед'}]]
ледяную гряду	[['ледяной', {'вин,ед'}], ['гряда', {'вин,ед'}]]
ледяная баня	[['ледяной', {'им,ед'}], ['баня', {'им,ед'}]]
ледяному скату	[['ледяной', {'дат,ед'}], ['скат', {'дат,ед'}]]
ледяными объятиями	[['ледяной', {'твор,мн'}], ['объятие', {'твор,мн'}]]
ледяные обрывы	[['ледяной', {'вин,мн', 'им,мн'}], ['обрыв', {'вин,мн', 'им,мн'}]]
ледяного пояса	[['ледяной', {'род,ед', 'вин,ед'}], ['пояс', {'вин,мн', 'род,ед', 'им,мн'}]]
ледяным слоем	[['ледяной', {'дат,мн', 'твор,ед'}], ['слой', {'твор,ед'}]]
ледяном молчании	[['ледяной', {'пр,ед'}], ['молчание', {'пр,ед'}]]
ледяной линзой	[['ледяной', {'твор,ед', 'пр,ед', 'дат,ед', 'им,ед', 'род,ед', 'вин,ед'}], ['линза', {'твор,ед'}]]
ледяной сквознячок	[['ледяной', {'твор,ед', 'пр,ед', 'дат,ед', 'им,ед', 'род,ед', 'вин,ед'}], ['сквознячок', {'вин,ед', 'им,ед'}]]
ледяных горок	[['ледяной', {'пр,мн', 'род,мн', 'вин,мн'}], ['горка', {'род,мн'}]]
ледяные обвалы	[['ледяной', {'вин,мн', 'им,мн'}], ['обвал', {'вин,мн', 'им,мн'}]]
ледяного хаоса	[['ледяной', {'род,ед', 'вин,ед'}], ['хаос', {'род,ед'}]]
ледяных цветах	[['ледяной', {'пр,мн', 'род,мн', 'вин,мн'}], ['цвет', {'пр,мн'}]]
ледяной выступ	[['ледяной', {'твор,ед', 'пр,ед', 'дат,ед', 'им,ед', 'род,ед', 'вин,ед'}], ['выступ', {'вин,ед', 'им,ед'}]]
ледяные гряды	[['ледяной', {'вин,мн', 'им,мн'}], ['гряда', {'вин,мн', 'род,ед', 'им,мн'}]]
ледяном подъеме	[['ледяной', {'пр,ед'}], ['подъем', {'пр,ед'}]]
ледяную арену	[['ледяной', {'вин,ед'}], ['арена', {'вин,ед'}]]
ледяной омут	[['ледяной', {'твор,ед', 'пр,ед', 'дат,ед', 'им,ед', 'род,ед', 'вин,ед'}], ['омут', {'вин,ед', 'им,ед'}]]
ледяном краю	[['ледяной', {'пр,ед'}], ['край', {'дат,ед', 'местн,ед'}]]
ледяной почвы	[['ледяной', {'твор,ед', 'пр,ед', 'дат,ед', 'им,ед', 'род,ед', 'вин,ед'}], ['почва', {'вин,мн', 'род,ед', 'им,мн'}]]
ледяной ад	[['ледяной', {'твор,ед', 'пр,ед', 'дат,ед', 'им,ед', 'род,ед', 'вин,ед'}], ['ад', {'вин,ед', 'им,ед'}]]
ледяном погребе	[['ледяной', {'пр,ед'}], ['погреб', {'пр,ед'}]]
ледяной мир	[['ледяной', {'твор,ед', 'пр,ед', 'дат,ед', 'им,ед', 'род,ед', 'вин,ед'}], ['мир', {'вин,ед', 'им,ед'}]]
ледяные комья	[['ледяной', {'вин,мн', 'им,мн'}], ['ком', {'вин,мн', 'им,мн'}]]
ледяное сердце	[['ледяной', {'вин,ед', 'им,ед'}], ['сердце', {'пр,ед', 'вин,ед', 'им,ед'}]]
ледяной горб	[['ледяной', {'твор,ед', 'пр,ед', 'дат,ед', 'им,ед', 'род,ед', 'вин,ед'}], ['горб', {'вин,ед', 'им,ед'}]]
ледяном поле	[['ледяной', {'пр,ед'}], ['поле', {'пр,ед', 'вин,ед', 'им,ед'}]]
ледяных дорожек	[['ледяной', {'пр,мн', 'род,мн', 'вин,мн'}], ['дорожка', {'род,мн'}]]
ледяная крепость	[['ледяной', {'им,ед'}], ['крепость', {'вин,ед', 'им,ед'}]]
ледяных ядрах	[['ледяной', {'пр,мн', 'род,мн', 'вин,мн'}], ['ядро', {'пр,мн'}]]
ледяной тропе	[['ледяной', {'твор,ед', 'пр,ед', 'дат,ед', 'им,ед', 'род,ед', 'вин,ед'}], ['тропа', {'дат,ед', 'пр,ед'}]]
ледяной металл	[['ледяной', {'твор,ед', 'пр,ед', 'дат,ед', 'им,ед', 'род,ед', 'вин,ед'}], ['металл', {'вин,ед', 'им,ед'}]]
ледяную пустыню	[['ледяной', {'вин,ед'}], ['пустыня', {'вин,ед'}]]
ледяном поту	[['ледяной', {'пр,ед'}], ['пот', {'дат,ед', 'парт,ед', 'местн,ед'}]]
ледяной день	[['ледяной', {'твор,ед', 'пр,ед', 'дат,ед', 'им,ед', 'род,ед', 'вин,ед'}], ['день', {'вин,ед', 'им,ед'}]]
ледяной водицы	[['ледяной', {'твор,ед', 'пр,ед', 'дат,ед', 'им,ед', 'род,ед', 'вин,ед'}], ['водица', {'вин,мн', 'род,ед', 'им,мн'}]]
ледяные столбики	[['ледяной', {'вин,мн', 'им,мн'}], ['столбик', {'вин,мн', 'им,мн'}]]
ледяном оцепенении	[['ледяной', {'пр,ед'}], ['оцепенение', {'пр,ед'}]]
ледяной комнаты	[['ледяной', {'твор,ед', 'пр,ед', 'дат,ед', 'им,ед', 'род,ед', 'вин,ед'}], ['комната', {'вин,мн', 'род,ед', 'им,мн'}]]
ледяной расчет	[['ледяной', {'твор,ед', 'пр,ед', 'дат,ед', 'им,ед', 'род,ед', 'вин,ед'}], ['расчет', {'вин,ед', 'им,ед'}]]
ледяным ветерком	[['ледяной', {'дат,мн', 'твор,ед'}], ['ветерок', {'твор,ед'}]]
ледяную страну	[['ледяной', {'вин,ед'}], ['страна', {'вин,ед'}]]
ледяной каши	[['ледяной', {'твор,ед', 'пр,ед', 'дат,ед', 'им,ед', 'род,ед', 'вин,ед'}], ['каша', {'вин,мн', 'род,ед', 'им,мн'}]]
ледяные крупинки	[['ледяной', {'вин,мн', 'им,мн'}], ['крупинка', {'вин,мн', 'род,ед', 'им,мн'}]]
ледяными включениями	[['ледяной', {'твор,мн'}], ['включение', {'твор,мн'}]]
ледяное безмолвие	[['ледяной', {'вин,ед', 'им,ед'}], ['безмолвие', {'вин,ед', 'им,ед'}]]
ледяным безразличием	[['ледяной', {'дат,мн', 'твор,ед'}], ['безразличие', {'твор,ед'}]]
ледяные его	[['ледяной', {'вин,мн', 'им,мн'}], ['его', set()]]
ледяную ладонь	[['ледяной', {'вин,ед'}], ['ладонь', {'вин,ед', 'им,ед'}]]
ледяного тумана	[['ледяной', {'род,ед', 'вин,ед'}], ['туман', {'род,ед'}]]
ледяными сталактитами	[['ледяной', {'твор,мн'}], ['сталактит', {'твор,мн'}]]
ледяного побережья	[['ледяной', {'род,ед', 'вин,ед'}], ['побережье', {'вин,мн', 'род,ед', 'им,мн'}]]
ледяной душ	[['ледяной', {'твор,ед', 'пр,ед', 'дат,ед', 'им,ед', 'род,ед', 'вин,ед'}], ['душ', {'вин,ед', 'им,ед'}]]
ледяной шапки	[['ледяной', {'твор,ед', 'пр,ед', 'дат,ед', 'им,ед', 'род,ед', 'вин,ед'}], ['шапка', {'вин,мн', 'род,ед', 'им,мн'}]]
ледяном берегу	[['ледяной', {'пр,ед'}], ['берег', {'дат,ед', 'местн,ед'}]]
ледяному склону	[['ледяной', {'дат,ед'}], ['склон', {'дат,ед'}]]
ледяного панциря	[['ледяной', {'род,ед', 'вин,ед'}], ['панцирь', {'род,ед'}]]
ледяные плотины	[['ледяной', {'вин,мн', 'им,мн'}], ['плотина', {'вин,мн', 'род,ед', 'им,мн'}]]
ледяных походов	[['ледяной', {'пр,мн', 'род,мн', 'вин,мн'}], ['поход', {'род,мн'}]]
ледяной груди	[['ледяной', {'твор,ед', 'пр,ед', 'дат,ед', 'им,ед', 'род,ед', 'вин,ед'}], ['грудь', {'вин,мн', 'дат,ед', 'пр,ед', 'род,ед', 'им,мн'}]]
ледяном припае	[['ледяной', {'пр,ед'}], ['припай', {'пр,ед'}]]
ледяной пластине	[['ледяной', {'твор,ед', 'пр,ед', 'дат,ед', 'им,ед', 'род,ед', 'вин,ед'}], ['пластина', {'дат,ед', 'пр,ед'}]]
ледяной отблеск	[['ледяной', {'твор,ед', 'пр,ед', 'дат,ед', 'им,ед', 'род,ед', 'вин,ед'}], ['отблеск', {'вин,ед', 'им,ед'}]]
ледяной кухне	[['ледяной', {'твор,ед', 'пр,ед', 'дат,ед', 'им,ед', 'род,ед', 'вин,ед'}], ['кухня', {'дат,ед', 'пр,ед'}]]
ледяную шапку	[['ледяной', {'вин,ед'}], ['шапка', {'вин,ед'}]]
ледяные укрепления	[['ледяной', {'вин,мн', 'им,мн'}], ['укрепление', {'вин,мн', 'род,ед', 'им,мн'}]]
ледяная струя	[['ледяной', {'им,ед'}], ['струя', {'им,ед'}]]
ледяное месиво	[['ледяной', {'вин,ед', 'им,ед'}], ['месиво', {'вин,ед', 'им,ед'}]]
ледяных окопах	[['ледяной', {'пр,мн', 'род,мн', 'вин,мн'}], ['окоп', {'пр,мн'}]]
ледяной шарик	[['ледяной', {'твор,ед', 'пр,ед', 'дат,ед', 'им,ед', 'род,ед', 'вин,ед'}], ['шарик', {'вин,ед', 'им,ед'}]]
ледяного ручья	[['ледяной', {'род,ед', 'вин,ед'}], ['ручей', {'род,ед'}]]
ледяными взглядами	[['ледяной', {'твор,мн'}], ['взгляд', {'твор,мн'}]]
ледяного купола	[['ледяной', {'род,ед', 'вин,ед'}], ['купол', {'вин,мн', 'род,ед', 'им,мн'}]]
ледяные зубы	[['ледяной', {'вин,мн', 'им,мн'}], ['зуб', {'вин,мн', 'им,мн'}]]
ледяные блоки	[['ледяной', {'вин,мн', 'им,мн'}], ['блок', {'вин,мн', 'им,мн'}]]
ледяную плотину	[['ледяной', {'вин,ед'}], ['плотина', {'вин,ед'}]]
ледяном чану	[['ледяной', {'пр,ед'}], ['чан', {'дат,ед', 'местн,ед'}]]
ледяным узором	[['ледяной', {'дат,мн', 'твор,ед'}], ['узор', {'твор,ед'}]]
ледяные руки	[['ледяной', {'вин,мн', 'им,мн'}], ['рука', {'вин,мн', 'род,ед', 'им,мн'}]]
ледяной пурги	[['ледяной', {'твор,ед', 'пр,ед', 'дат,ед', 'им,ед', 'род,ед', 'вин,ед'}], ['пурга', {'род,ед'}]]
ледяным жилам	[['ледяной', {'дат,мн', 'твор,ед'}], ['жила', {'дат,мн'}]]
ледяных прослойков	[['ледяной', {'пр,мн', 'род,мн', 'вин,мн'}], ['прослоек', {'род,мн'}]]
ледяного панцыря	[['ледяной', {'род,ед', 'вин,ед'}], ['панцырь', {'род,ед'}]]
ледяная капля	[['ледяной', {'им,ед'}], ['капля', {'им,ед'}]]
ледяном мире	[['ледяной', {'пр,ед'}], ['мир', {'пр,ед'}]]
ледяного нароста	[['ледяной', {'род,ед', 'вин,ед'}], ['нарост', {'род,ед'}]]
ледяных складов	[['ледяной', {'пр,мн', 'род,мн', 'вин,мн'}], ['склад', {'род,мн'}]]
ледяной рекой	[['ледяной', {'твор,ед', 'пр,ед', 'дат,ед', 'им,ед', 'род,ед', 'вин,ед'}], ['река', {'твор,ед'}]]
ледяными цветами	[['ледяной', {'твор,мн'}], ['цветок', {'твор,мн'}]]
ледяных ключей	[['ледяной', {'пр,мн', 'род,мн', 'вин,мн'}], ['ключ', {'род,мн'}]]
ледяной пленки	[['ледяной', {'твор,ед', 'пр,ед', 'дат,ед', 'им,ед', 'род,ед', 'вин,ед'}], ['пленка', {'вин,мн', 'род,ед', 'им,мн'}]]
ледяному покрову	[['ледяной', {'дат,ед'}], ['покров', {'дат,ед'}]]
ледяных склонов	[['ледяной', {'пр,мн', 'род,мн', 'вин,мн'}], ['склон', {'род,мн'}]]
ледяного склона	[['ледяной', {'род,ед', 'вин,ед'}], ['склон', {'род,ед'}]]
ледяным светом	[['ледяной', {'дат,мн', 'твор,ед'}], ['свет', {'твор,ед'}]]
ледяного по	[['ледяной', {'род,ед', 'вин,ед'}], ['по', set()]]
ледяного квасу	[['ледяной', {'род,ед', 'вин,ед'}], ['квас', {'дат,ед', 'парт,ед'}]]
ледяной коры	[['ледяной', {'твор,ед', 'пр,ед', 'дат,ед', 'им,ед', 'род,ед', 'вин,ед'}], ['кора', {'род,ед'}]]
ледяная линза	[['ледяной', {'им,ед'}], ['линза', {'им,ед'}]]
ледяными сферами	[['ледяной', {'твор,мн'}], ['сфера', {'твор,мн'}]]
ледяной частицей	[['ледяной', {'твор,ед', 'пр,ед', 'дат,ед', 'им,ед', 'род,ед', 'вин,ед'}], ['частица', {'твор,ед'}]]
ледяные стебельки	[['ледяной', {'вин,мн', 'им,мн'}], ['стебелек', {'вин,мн', 'им,мн'}]]
ледяным взором	[['ледяной', {'дат,мн', 'твор,ед'}], ['взор', {'твор,ед'}]]
ледяные облака	[['ледяной', {'вин,мн', 'им,мн'}], ['облако', {'вин,мн', 'род,ед', 'им,мн'}]]
ледяные струи	[['ледяной', {'вин,мн', 'им,мн'}], ['струя', {'вин,мн', 'род,ед', 'им,мн'}]]
ледяным домом	[['ледяной', {'дат,мн', 'твор,ед'}], ['дом', {'твор,ед'}]]
ледяная сосулька	[['ледяной', {'им,ед'}], ['сосулька', {'им,ед'}]]
ледяного охлаждения	[['ледяной', {'род,ед', 'вин,ед'}], ['охлаждение', {'вин,мн', 'род,ед', 'им,мн'}]]
ледяных игол	[['ледяной', {'пр,мн', 'род,мн', 'вин,мн'}], ['игол', {'им,ед'}]]
ледяной потолок	[['ледяной', {'твор,ед', 'пр,ед', 'дат,ед', 'им,ед', 'род,ед', 'вин,ед'}], ['потолок', {'вин,ед', 'им,ед'}]]
ледяного покрытия	[['ледяной', {'род,ед', 'вин,ед'}], ['покрытие', {'вин,мн', 'род,ед', 'им,мн'}]]
ледяного пола	[['ледяной', {'род,ед', 'вин,ед'}], ['пол', {'род,ед'}]]
ледяной причал	[['ледяной', {'твор,ед', 'пр,ед', 'дат,ед', 'им,ед', 'род,ед', 'вин,ед'}], ['причал', {'вин,ед', 'им,ед'}]]
ледяной кока	[['ледяной', {'твор,ед', 'пр,ед', 'дат,ед', 'им,ед', 'род,ед', 'вин,ед'}], ['кока', {'им,ед'}]]
ледяной зоной	[['ледяной', {'твор,ед', 'пр,ед', 'дат,ед', 'им,ед', 'род,ед', 'вин,ед'}], ['зона', {'твор,ед'}]]
ледяном склоне	[['ледяной', {'пр,ед'}], ['склон', {'пр,ед'}]]
ледяного круга	[['ледяной', {'род,ед', 'вин,ед'}], ['круг', {'род,ед'}]]
ледяном дворце	[['ледяной', {'пр,ед'}], ['дворец', {'пр,ед'}]]
ледяных включений	[['ледяной', {'пр,мн', 'род,мн', 'вин,мн'}], ['включение', {'род,мн'}]]
ледяной линзе	[['ледяной', {'твор,ед', 'пр,ед', 'дат,ед', 'им,ед', 'род,ед', 'вин,ед'}], ['линза', {'дат,ед', 'пр,ед'}]]
ледяное равнодушие	[['ледяной', {'вин,ед', 'им,ед'}], ['равнодушие', {'вин,ед', 'им,ед'}]]
ледяных хребтов	[['ледяной', {'пр,мн', 'род,мн', 'вин,мн'}], ['хребет', {'род,мн'}]]
ледяном растворе	[['ледяной', {'пр,ед'}], ['раствор', {'пр,ед'}]]
ледяную водку	[['ледяной', {'вин,ед'}], ['водка', {'вин,ед'}]]
ледяной глади	[['ледяной', {'твор,ед', 'пр,ед', 'дат,ед', 'им,ед', 'род,ед', 'вин,ед'}], ['гладь', {'вин,мн', 'дат,ед', 'пр,ед', 'род,ед', 'им,мн'}]]
ледяной струи	[['ледяной', {'твор,ед', 'пр,ед', 'дат,ед', 'им,ед', 'род,ед', 'вин,ед'}], ['струя', {'вин,мн', 'род,ед', 'им,мн'}]]
ледяного графина	[['ледяной', {'род,ед', 'вин,ед'}], ['графин', {'род,ед'}]]
ледяным уступам	[['ледяной', {'дат,мн', 'твор,ед'}], ['уступ', {'дат,мн'}]]
ледяного зеркала	[['ледяной', {'род,ед', 'вин,ед'}], ['зеркало', {'вин,мн', 'род,ед', 'им,мн'}]]
ледяной берег	[['ледяной', {'твор,ед', 'пр,ед', 'дат,ед', 'им,ед', 'род,ед', 'вин,ед'}], ['берег', {'вин,ед', 'им,ед'}]]
ледяных степях	[['ледяной', {'пр,мн', 'род,мн', 'вин,мн'}], ['степь', {'пр,мн'}]]
ледяную волну	[['ледяной', {'вин,ед'}], ['волна', {'вин,ед'}]]
ледяной прорубью	[['ледяной', {'твор,ед', 'пр,ед', 'дат,ед', 'им,ед', 'род,ед', 'вин,ед'}], ['прорубь', {'твор,ед'}]]
ледяного пути	[['ледяной', {'род,ед', 'вин,ед'}], ['путь', {'вин,мн', 'дат,ед', 'пр,ед', 'род,ед', 'им,мн'}]]
ледяных линз	[['ледяной', {'пр,мн', 'род,мн', 'вин,мн'}], ['линза', {'род,мн'}]]
ледяные степи	[['ледяной', {'вин,мн', 'им,мн'}], ['степь', {'вин,мн', 'дат,ед', 'пр,ед', 'род,ед', 'им,мн'}]]
ледяному щиту	[['ледяной', {'дат,ед'}], ['щит', {'дат,ед'}]]
ледяные забереги	[['ледяной', {'вин,мн', 'им,мн'}], ['заберег', {'вин,мн', 'им,мн'}]]
ледяного рельефа	[['ледяной', {'род,ед', 'вин,ед'}], ['рельеф', {'род,ед'}]]
ледяные потоки	[['ледяной', {'вин,мн', 'им,мн'}], ['поток', {'вин,мн', 'им,мн'}]]
ледяной столб	[['ледяной', {'твор,ед', 'пр,ед', 'дат,ед', 'им,ед', 'род,ед', 'вин,ед'}], ['столб', {'вин,ед', 'им,ед'}]]
ледяной пузырь	[['ледяной', {'твор,ед', 'пр,ед', 'дат,ед', 'им,ед', 'род,ед', 'вин,ед'}], ['пузырь', {'вин,ед', 'им,ед'}]]
ледяными глыбами	[['ледяной', {'твор,мн'}], ['глыба', {'твор,мн'}]]
ледяную перемычку	[['ледяной', {'вин,ед'}], ['перемычка', {'вин,ед'}]]
ледяной пояс	[['ледяной', {'твор,ед', 'пр,ед', 'дат,ед', 'им,ед', 'род,ед', 'вин,ед'}], ['пояс', {'вин,ед', 'им,ед'}]]
ледяной пар	[['ледяной', {'твор,ед', 'пр,ед', 'дат,ед', 'им,ед', 'род,ед', 'вин,ед'}], ['пар', {'вин,ед', 'им,ед'}]]
ледяные зимы	[['ледяной', {'вин,мн', 'им,мн'}], ['зима', {'вин,мн', 'род,ед', 'им,мн'}]]
ледяной сосульки	[['ледяной', {'твор,ед', 'пр,ед', 'дат,ед', 'им,ед', 'род,ед', 'вин,ед'}], ['сосулька', {'вин,мн', 'род,ед', 'им,мн'}]]
ледяном аэродроме	[['ледяной', {'пр,ед'}], ['аэродром', {'пр,ед'}]]
ледяным стеклом	[['ледяной', {'дат,мн', 'твор,ед'}], ['стекло', {'твор,ед'}]]
ледяном узоре	[['ледяной', {'пр,ед'}], ['узор', {'пр,ед'}]]
ледяная бахрома	[['ледяной', {'им,ед'}], ['бахрома', {'им,ед'}]]
ледяную речку	[['ледяной', {'вин,ед'}], ['речка', {'вин,ед'}]]
ледяную крошку	[['ледяной', {'вин,ед'}], ['крошка', {'вин,ед'}]]
ледяной дорожке	[['ледяной', {'твор,ед', 'пр,ед', 'дат,ед', 'им,ед', 'род,ед', 'вин,ед'}], ['дорожка', {'дат,ед', 'пр,ед'}]]
ледяною водой	[['ледяной', {'твор,ед'}], ['вода', {'твор,ед'}]]
ледяным тропинкам	[['ледяной', {'дат,мн', 'твор,ед'}], ['тропинка', {'дат,мн'}]]
ледяным глыбам	[['ледяной', {'дат,мн', 'твор,ед'}], ['глыба', {'дат,мн'}]]
ледяных массивов	[['ледяной', {'пр,мн', 'род,мн', 'вин,мн'}], ['массив', {'род,мн'}]]
ледяную глубь	[['ледяной', {'вин,ед'}], ['глубь', {'вин,ед', 'им,ед'}]]
ледяного севера	[['ледяной', {'род,ед', 'вин,ед'}], ['север', {'род,ед'}]]
ледяных рук	[['ледяной', {'пр,мн', 'род,мн', 'вин,мн'}], ['рука', {'род,мн'}]]
ледяных облаков	[['ледяной', {'пр,мн', 'род,мн', 'вин,мн'}], ['облако', {'род,мн'}]]
ледяной сыростью	[['ледяной', {'твор,ед', 'пр,ед', 'дат,ед', 'им,ед', 'род,ед', 'вин,ед'}], ['сырость', {'твор,ед'}]]
ледяное озеро	[['ледяной', {'вин,ед', 'им,ед'}], ['озеро', {'вин,ед', 'им,ед'}]]
ледяными ногами	[['ледяной', {'твор,мн'}], ['нога', {'твор,мн'}]]
ледяное облако	[['ледяной', {'вин,ед', 'им,ед'}], ['облако', {'вин,ед', 'им,ед'}]]
ледяных телах	[['ледяной', {'пр,мн', 'род,мн', 'вин,мн'}], ['тело', {'пр,мн'}]]
ледяная холодность	[['ледяной', {'им,ед'}], ['холодность', {'вин,ед', 'им,ед'}]]
ледяной дворец	[['ледяной', {'твор,ед', 'пр,ед', 'дат,ед', 'им,ед', 'род,ед', 'вин,ед'}], ['дворец', {'вин,ед', 'им,ед'}]]
ледяного мешка	[['ледяной', {'род,ед', 'вин,ед'}], ['мешок', {'род,ед'}]]
ледяные глыбы	[['ледяной', {'вин,мн', 'им,мн'}], ['глыба', {'вин,мн', 'род,ед', 'им,мн'}]]
ледяное небо	[['ледяной', {'вин,ед', 'им,ед'}], ['небо', {'вин,ед', 'им,ед'}]]
ледяного воздуха	[['ледяной', {'род,ед', 'вин,ед'}], ['воздух', {'род,ед'}]]
ледяной бури	[['ледяной', {'твор,ед', 'пр,ед', 'дат,ед', 'им,ед', 'род,ед', 'вин,ед'}], ['буря', {'вин,мн', 'род,ед', 'им,мн'}]]
ледяной толщей	[['ледяной', {'твор,ед', 'пр,ед', 'дат,ед', 'им,ед', 'род,ед', 'вин,ед'}], ['толща', {'твор,ед'}]]
ледяной айсберг	[['ледяной', {'твор,ед', 'пр,ед', 'дат,ед', 'им,ед', 'род,ед', 'вин,ед'}], ['айсберг', {'вин,ед', 'им,ед'}]]
ледяную закраину	[['ледяной', {'вин,ед'}], ['закраина', {'вин,ед'}]]
ледяных кернов	[['ледяной', {'пр,мн', 'род,мн', 'вин,мн'}], ['керн', {'род,мн'}]]
ледяной массе	[['ледяной', {'твор,ед', 'пр,ед', 'дат,ед', 'им,ед', 'род,ед', 'вин,ед'}], ['масса', {'дат,ед', 'пр,ед'}]]
ледяного пласта	[['ледяной', {'род,ед', 'вин,ед'}], ['пласт', {'род,ед'}]]
ледяных шариков	[['ледяной', {'пр,мн', 'род,мн', 'вин,мн'}], ['шарик', {'род,мн'}]]
ледяным клиньям	[['ледяной', {'дат,мн', 'твор,ед'}], ['клин', {'дат,мн'}]]
ледяного цилиндра	[['ледяной', {'род,ед', 'вин,ед'}], ['цилиндр', {'род,ед'}]]
ледяную преграду	[['ледяной', {'вин,ед'}], ['преграда', {'вин,ед'}]]
ледяная земля	[['ледяной', {'им,ед'}], ['земля', {'им,ед'}]]
ледяных торосов	[['ледяной', {'пр,мн', 'род,мн', 'вин,мн'}], ['торос', {'род,мн'}]]
ледяная империя	[['ледяной', {'им,ед'}], ['империя', {'им,ед'}]]
ледяной вежливости	[['ледяной', {'твор,ед', 'пр,ед', 'дат,ед', 'им,ед', 'род,ед', 'вин,ед'}], ['вежливость', {'вин,мн', 'дат,ед', 'пр,ед', 'род,ед', 'им,мн'}]]
ледяная фигура	[['ледяной', {'им,ед'}], ['фигура', {'им,ед'}]]
ледяными линзами	[['ледяной', {'твор,мн'}], ['линза', {'твор,мн'}]]
ледяной стужей	[['ледяной', {'твор,ед', 'пр,ед', 'дат,ед', 'им,ед', 'род,ед', 'вин,ед'}], ['стужа', {'твор,ед'}]]
ледяную реку	[['ледяной', {'вин,ед'}], ['река', {'вин,ед'}]]
ледяными цепями	[['ледяной', {'твор,мн'}], ['цепь', {'твор,мн'}]]
ледяная зима	[['ледяной', {'им,ед'}], ['зима', {'им,ед'}]]
ледяная тьма	[['ледяной', {'им,ед'}], ['тьма', {'им,ед'}]]
ледяной оболочке	[['ледяной', {'твор,ед', 'пр,ед', 'дат,ед', 'им,ед', 'род,ед', 'вин,ед'}], ['оболочка', {'дат,ед', 'пр,ед'}]]
ледяной ком	[['ледяной', {'твор,ед', 'пр,ед', 'дат,ед', 'им,ед', 'род,ед', 'вин,ед'}], ['ком', {'вин,ед', 'им,ед'}]]
ледяной край	[['ледяной', {'твор,ед', 'пр,ед', 'дат,ед', 'им,ед', 'род,ед', 'вин,ед'}], ['край', {'вин,ед', 'им,ед'}]]
ледяной дорожки	[['ледяной', {'твор,ед', 'пр,ед', 'дат,ед', 'им,ед', 'род,ед', 'вин,ед'}], ['дорожка', {'вин,мн', 'род,ед', 'им,мн'}]]
ледяных глубин	[['ледяной', {'пр,мн', 'род,мн', 'вин,мн'}], ['глубина', {'род,мн'}]]
ледяного плена	[['ледяной', {'род,ед', 'вин,ед'}], ['плен', {'род,ед'}]]
ледяной фазы	[['ледяной', {'твор,ед', 'пр,ед', 'дат,ед', 'им,ед', 'род,ед', 'вин,ед'}], ['фаза', {'вин,мн', 'род,ед', 'им,мн'}]]
ледяного мрака	[['ледяной', {'род,ед', 'вин,ед'}], ['мрак', {'род,ед'}]]
ледяная кружка	[['ледяной', {'им,ед'}], ['кружка', {'им,ед'}]]
ледяных облаках	[['ледяной', {'пр,мн', 'род,мн', 'вин,мн'}], ['облако', {'пр,мн'}]]
ледяные пальцы	[['ледяной', {'вин,мн', 'им,мн'}], ['палец', {'вин,мн', 'им,мн'}]]
ледяной булавой	[['ледяной', {'твор,ед', 'пр,ед', 'дат,ед', 'им,ед', 'род,ед', 'вин,ед'}], ['булава', {'твор,ед'}]]
ледяное покрытие	[['ледяной', {'вин,ед', 'им,ед'}], ['покрытие', {'вин,ед', 'им,ед'}]]
ледяной улыбкой	[['ледяной', {'твор,ед', 'пр,ед', 'дат,ед', 'им,ед', 'род,ед', 'вин,ед'}], ['улыбка', {'твор,ед'}]]
ледяных обвалов	[['ледяной', {'пр,мн', 'род,мн', 'вин,мн'}], ['обвал', {'род,мн'}]]
ледяным дорогам	[['ледяной', {'дат,мн', 'твор,ед'}], ['дорога', {'дат,мн'}]]
ледяной поверхности	[['ледяной', {'твор,ед', 'пр,ед', 'дат,ед', 'им,ед', 'род,ед', 'вин,ед'}], ['поверхность', {'вин,мн', 'дат,ед', 'пр,ед', 'род,ед', 'им,мн'}]]
ледяные столы	[['ледяной', {'вин,мн', 'им,мн'}], ['стол', {'вин,мн', 'им,мн'}]]
ледяные аллеи	[['ледяной', {'вин,мн', 'им,мн'}], ['аллея', {'вин,мн', 'род,ед', 'им,мн'}]]
ледяную корочку	[['ледяной', {'вин,ед'}], ['корочка', {'вин,ед'}]]
ледяного облака	[['ледяной', {'род,ед', 'вин,ед'}], ['облако', {'вин,мн', 'род,ед', 'им,мн'}]]
ледяного простора	[['ледяной', {'род,ед', 'вин,ед'}], ['простор', {'род,ед'}]]
ледяной коростой	[['ледяной', {'твор,ед', 'пр,ед', 'дат,ед', 'им,ед', 'род,ед', 'вин,ед'}], ['короста', {'твор,ед'}]]
ледяных сердец	[['ледяной', {'пр,мн', 'род,мн', 'вин,мн'}], ['сердце', {'род,мн'}]]
ледяные колонны	[['ледяной', {'вин,мн', 'им,мн'}], ['колонна', {'вин,мн', 'род,ед', 'им,мн'}]]
ледяных перемычек	[['ледяной', {'пр,мн', 'род,мн', 'вин,мн'}], ['перемычка', {'род,мн'}]]
ледяного кваса	[['ледяной', {'род,ед', 'вин,ед'}], ['квас', {'род,ед'}]]
ледяных прослоек	[['ледяной', {'пр,мн', 'род,мн', 'вин,мн'}], ['прослоек', {'вин,ед', 'им,ед'}]]
ледяная водка	[['ледяной', {'им,ед'}], ['водка', {'им,ед'}]]
ледяные пласты	[['ледяной', {'вин,мн', 'им,мн'}], ['пласт', {'вин,мн', 'им,мн'}]]
ледяными куполами	[['ледяной', {'твор,мн'}], ['купол', {'твор,мн'}]]
ледяную пленку	[['ледяной', {'вин,ед'}], ['пленка', {'вин,ед'}]]
ледяною корочкой	[['ледяной', {'твор,ед'}], ['корочка', {'твор,ед'}]]
ледяного венца	[['ледяной', {'род,ед', 'вин,ед'}], ['венец', {'род,ед'}]]
ледяных частицах	[['ледяной', {'пр,мн', 'род,мн', 'вин,мн'}], ['частица', {'пр,мн'}]]
ледяные домики	[['ледяной', {'вин,мн', 'им,мн'}], ['домик', {'вин,мн', 'им,мн'}]]
ледяной сквозняк	[['ледяной', {'твор,ед', 'пр,ед', 'дат,ед', 'им,ед', 'род,ед', 'вин,ед'}], ['сквозняк', {'вин,ед', 'им,ед'}]]
ледяной дорогой	[['ледяной', {'твор,ед', 'пр,ед', 'дат,ед', 'им,ед', 'род,ед', 'вин,ед'}], ['дорога', {'твор,ед'}]]
ледяными каплями	[['ледяной', {'твор,мн'}], ['капля', {'твор,мн'}]]
ледяной руке	[['ледяной', {'твор,ед', 'пр,ед', 'дат,ед', 'им,ед', 'род,ед', 'вин,ед'}], ['рука', {'дат,ед', 'пр,ед'}]]
ледяных метеоритов	[['ледяной', {'пр,мн', 'род,мн', 'вин,мн'}], ['метеорит', {'род,мн'}]]
ледяных наслоений	[['ледяной', {'пр,мн', 'род,мн', 'вин,мн'}], ['наслоение', {'род,мн'}]]
ледяной город	[['ледяной', {'твор,ед', 'пр,ед', 'дат,ед', 'им,ед', 'род,ед', 'вин,ед'}], ['город', {'вин,ед', 'им,ед'}]]
ледяными когтями	[['ледяной', {'твор,мн'}], ['коготь', {'твор,мн'}]]
ледяными струями	[['ледяной', {'твор,мн'}], ['струя', {'твор,мн'}]]
ледяному крошеву	[['ледяной', {'дат,ед'}], ['крошево', {'дат,ед'}]]
ледяной воздух	[['ледяной', {'твор,ед', 'пр,ед', 'дат,ед', 'им,ед', 'род,ед', 'вин,ед'}], ['воздух', {'вин,ед', 'им,ед'}]]
ледяному морю	[['ледяной', {'дат,ед'}], ['море', {'дат,ед'}]]
ледяная площадка	[['ледяной', {'им,ед'}], ['площадка', {'им,ед'}]]
ледяной пустоте	[['ледяной', {'твор,ед', 'пр,ед', 'дат,ед', 'им,ед', 'род,ед', 'вин,ед'}], ['пустота', {'дат,ед', 'пр,ед'}]]
ледяной воде	[['ледяной', {'твор,ед', 'пр,ед', 'дат,ед', 'им,ед', 'род,ед', 'вин,ед'}], ['вода', {'дат,ед', 'пр,ед'}]]
ледяной АсОН	[['ледяной', {'твор,ед', 'пр,ед', 'дат,ед', 'им,ед', 'род,ед', 'вин,ед'}], ['асон', {'им,ед'}]]
ледяном калориметре	[['ледяной', {'пр,ед'}], ['калориметр', {'пр,ед'}]]
ледяных кубиков	[['ледяной', {'пр,мн', 'род,мн', 'вин,мн'}], ['кубик', {'род,мн'}]]
ледяные поверхности	[['ледяной', {'вин,мн', 'им,мн'}], ['поверхность', {'вин,мн', 'дат,ед', 'пр,ед', 'род,ед', 'им,мн'}]]
ледяную тюрьму	[['ледяной', {'вин,ед'}], ['тюрьма', {'вин,ед'}]]
ледяные сферы	[['ледяной', {'вин,мн', 'им,мн'}], ['сфера', {'вин,мн', 'род,ед', 'им,мн'}]]
ледяной корочкой	[['ледяной', {'твор,ед', 'пр,ед', 'дат,ед', 'им,ед', 'род,ед', 'вин,ед'}], ['корочка', {'твор,ед'}]]
ледяные статуи	[['ледяной', {'вин,мн', 'им,мн'}], ['статуя', {'вин,мн', 'род,ед', 'им,мн'}]]
ледяного равнодушия	[['ледяной', {'род,ед', 'вин,ед'}], ['равнодушие', {'вин,мн', 'род,ед', 'им,мн'}]]
ледяных жилок	[['ледяной', {'пр,мн', 'род,мн', 'вин,мн'}], ['жилка', {'род,мн'}]]
ледяная преграда	[['ледяной', {'им,ед'}], ['преграда', {'им,ед'}]]
ледяные сквозняки	[['ледяной', {'вин,мн', 'им,мн'}], ['сквозняк', {'вин,мн', 'им,мн'}]]
ледяная скала	[['ледяной', {'им,ед'}], ['скала', {'им,ед'}]]
ледяными тисками	[['ледяной', {'твор,мн'}], ['тиски', {'твор,мн'}]]
ледяными просторами	[['ледяной', {'твор,мн'}], ['простор', {'твор,мн'}]]
ледяные уступы	[['ледяной', {'вин,мн', 'им,мн'}], ['уступ', {'вин,мн', 'им,мн'}]]
ледяные обломки	[['ледяной', {'вин,мн', 'им,мн'}], ['обломок', {'вин,мн', 'им,мн'}]]
ледяной огонь	[['ледяной', {'твор,ед', 'пр,ед', 'дат,ед', 'им,ед', 'род,ед', 'вин,ед'}], ['огонь', {'вин,ед', 'им,ед'}]]
ледяной страх	[['ледяной', {'твор,ед', 'пр,ед', 'дат,ед', 'им,ед', 'род,ед', 'вин,ед'}], ['страх', {'вин,ед', 'им,ед'}]]
ледяную тьму	[['ледяной', {'вин,ед'}], ['тьма', {'вин,ед'}]]
ледяные надолбы	[['ледяной', {'вин,мн', 'им,мн'}], ['надолба', {'вин,мн', 'род,ед', 'им,мн'}]]
ледяных цилиндров	[['ледяной', {'пр,мн', 'род,мн', 'вин,мн'}], ['цилиндр', {'род,мн'}]]
ледяным потоком	[['ледяной', {'дат,мн', 'твор,ед'}], ['поток', {'твор,ед'}]]
ледяном доме	[['ледяной', {'пр,ед'}], ['дом', {'пр,ед'}]]
ледяными звездами	[['ледяной', {'твор,мн'}], ['звезда', {'твор,мн'}]]
ледяное презрение	[['ледяной', {'вин,ед', 'им,ед'}], ['презрение', {'вин,ед', 'им,ед'}]]
ледяные валы	[['ледяной', {'вин,мн', 'им,мн'}], ['вал', {'вин,мн', 'им,мн'}]]
ледяных осколков	[['ледяной', {'пр,мн', 'род,мн', 'вин,мн'}], ['осколок', {'род,мн'}]]
ледяная кромка	[['ледяной', {'им,ед'}], ['кромка', {'им,ед'}]]
ледяные родники	[['ледяной', {'вин,мн', 'им,мн'}], ['родник', {'вин,мн', 'им,мн'}]]
ледяным щитом	[['ледяной', {'дат,мн', 'твор,ед'}], ['щит', {'твор,ед'}]]
ледяной компоненты	[['ледяной', {'твор,ед', 'пр,ед', 'дат,ед', 'им,ед', 'род,ед', 'вин,ед'}], ['компонент', {'вин,мн', 'им,мн'}]]
ледяные крепости	[['ледяной', {'вин,мн', 'им,мн'}], ['крепость', {'вин,мн', 'дат,ед', 'пр,ед', 'род,ед', 'им,мн'}]]
ледяной тверди	[['ледяной', {'твор,ед', 'пр,ед', 'дат,ед', 'им,ед', 'род,ед', 'вин,ед'}], ['твердь', {'вин,мн', 'дат,ед', 'пр,ед', 'род,ед', 'им,мн'}]]
ледяных пиков	[['ледяной', {'пр,мн', 'род,мн', 'вин,мн'}], ['пик', {'род,мн'}]]
ледяным покровом	[['ледяной', {'дат,мн', 'твор,ед'}], ['покров', {'твор,ед'}]]
ледяные наросты	[['ледяной', {'вин,мн', 'им,мн'}], ['нарост', {'вин,мн', 'им,мн'}]]
ледяных ночей	[['ледяной', {'пр,мн', 'род,мн', 'вин,мн'}], ['ночь', {'род,мн'}]]
ледяного мира	[['ледяной', {'род,ед', 'вин,ед'}], ['мир', {'род,ед'}]]
ледяного одиночества	[['ледяной', {'род,ед', 'вин,ед'}], ['одиночество', {'вин,мн', 'род,ед', 'им,мн'}]]
ледяным мостам	[['ледяной', {'дат,мн', 'твор,ед'}], ['мост', {'дат,мн'}]]
ледяной струей	[['ледяной', {'твор,ед', 'пр,ед', 'дат,ед', 'им,ед', 'род,ед', 'вин,ед'}], ['струя', {'твор,ед'}]]
ледяным охлаждением	[['ледяной', {'дат,мн', 'твор,ед'}], ['охлаждение', {'твор,ед'}]]
ледяные дороги	[['ледяной', {'вин,мн', 'им,мн'}], ['дорога', {'вин,мн', 'род,ед', 'им,мн'}]]
ледяная пробка	[['ледяной', {'им,ед'}], ['пробка', {'им,ед'}]]
ледяной пронизывающий	[['ледяной', {'твор,ед', 'пр,ед', 'дат,ед', 'им,ед', 'род,ед', 'вин,ед'}], ['пронизывающий', set()]]
ледяными пальчиками	[['ледяной', {'твор,мн'}], ['пальчик', {'твор,мн'}]]
ледяное крошево	[['ледяной', {'вин,ед', 'им,ед'}], ['крошево', {'вин,ед', 'им,ед'}]]
ледяном воздухе	[['ледяной', {'пр,ед'}], ['воздух', {'пр,ед'}]]
ледяных куполов	[['ледяной', {'пр,мн', 'род,мн', 'вин,мн'}], ['купол', {'род,мн'}]]
ледяных крупинок	[['ледяной', {'пр,мн', 'род,мн', 'вин,мн'}], ['крупинка', {'род,мн'}]]
ледяной зародыш	[['ледяной', {'твор,ед', 'пр,ед', 'дат,ед', 'им,ед', 'род,ед', 'вин,ед'}], ['зародыш', {'вин,ед', 'им,ед'}]]
ледяными холмами	[['ледяной', {'твор,мн'}], ['холм', {'твор,мн'}]]
ледяные края	[['ледяной', {'вин,мн', 'им,мн'}], ['край', {'вин,мн', 'род,ед', 'им,мн'}]]
ледяным полям	[['ледяной', {'дат,мн', 'твор,ед'}], ['поле', {'дат,мн'}]]
ледяной дрожью	[['ледяной', {'твор,ед', 'пр,ед', 'дат,ед', 'им,ед', 'род,ед', 'вин,ед'}], ['дрожь', {'твор,ед'}]]
ледяным тропам	[['ледяной', {'дат,мн', 'твор,ед'}], ['тропа', {'дат,мн'}]]
ледяная тоска	[['ледяной', {'им,ед'}], ['тоска', {'им,ед'}]]
ледяных пустынях	[['ледяной', {'пр,мн', 'род,мн', 'вин,мн'}], ['пустыня', {'пр,мн'}]]
ледяном стекле	[['ледяной', {'пр,ед'}], ['стекло', {'пр,ед'}]]
ледяные натеки	[['ледяной', {'вин,мн', 'им,мн'}], ['натек', {'вин,мн', 'им,мн'}]]
ледяным вином	[['ледяной', {'дат,мн', 'твор,ед'}], ['вино', {'твор,ед'}]]
ледяные иголочки	[['ледяной', {'вин,мн', 'им,мн'}], ['иголочка', {'вин,мн', 'род,ед', 'им,мн'}]]
ледяных волнах	[['ледяной', {'пр,мн', 'род,мн', 'вин,мн'}], ['волна', {'пр,мн'}]]
ледяных кристалликов	[['ледяной', {'пр,мн', 'род,мн', 'вин,мн'}], ['кристаллик', {'род,мн'}]]
ледяной тьме	[['ледяной', {'твор,ед', 'пр,ед', 'дат,ед', 'им,ед', 'род,ед', 'вин,ед'}], ['тьма', {'дат,ед', 'пр,ед'}]]
ледяное безразличие	[['ледяной', {'вин,ед', 'им,ед'}], ['безразличие', {'вин,ед', 'им,ед'}]]
ледяными прослойками	[['ледяной', {'твор,мн'}], ['прослоек', {'твор,мн'}]]
ледяного ядра	[['ледяной', {'род,ед', 'вин,ед'}], ['ядро', {'вин,мн', 'род,ед', 'им,мн'}]]
ледяными полями	[['ледяной', {'твор,мн'}], ['поле', {'твор,мн'}]]
ледяного крашения	[['ледяной', {'род,ед', 'вин,ед'}], ['крашение', {'вин,мн', 'род,ед', 'им,мн'}]]
ледяных шлиров	[['ледяной', {'пр,мн', 'род,мн', 'вин,мн'}], ['шлир', {'род,мн'}]]
ледяные мурашки	[['ледяной', {'вин,мн', 'им,мн'}], ['мурашки', {'вин,мн', 'им,мн'}]]
ледяным куполом	[['ледяной', {'дат,мн', 'твор,ед'}], ['купол', {'твор,ед'}]]
ледяным массивом	[['ледяной', {'дат,мн', 'твор,ед'}], ['массив', {'твор,ед'}]]
ледяной трассе	[['ледяной', {'твор,ед', 'пр,ед', 'дат,ед', 'им,ед', 'род,ед', 'вин,ед'}], ['трасса', {'дат,ед', 'пр,ед'}]]
ледяной ветерок	[['ледяной', {'твор,ед', 'пр,ед', 'дат,ед', 'им,ед', 'род,ед', 'вин,ед'}], ['ветерок', {'вин,ед', 'им,ед'}]]
ледяные включения	[['ледяной', {'вин,мн', 'им,мн'}], ['включение', {'вин,мн', 'род,ед', 'им,мн'}]]
ледяная слюда	[['ледяной', {'им,ед'}], ['слюда', {'им,ед'}]]
ледяным континентом	[['ледяной', {'дат,мн', 'твор,ед'}], ['континент', {'твор,ед'}]]
ледяные шапки	[['ледяной', {'вин,мн', 'им,мн'}], ['шапка', {'вин,мн', 'род,ед', 'им,мн'}]]
ледяной якорь	[['ледяной', {'твор,ед', 'пр,ед', 'дат,ед', 'им,ед', 'род,ед', 'вин,ед'}], ['якорь', {'вин,ед', 'им,ед'}]]
ледяной частицы	[['ледяной', {'твор,ед', 'пр,ед', 'дат,ед', 'им,ед', 'род,ед', 'вин,ед'}], ['частица', {'вин,мн', 'род,ед', 'им,мн'}]]
ледяная сырость	[['ледяной', {'им,ед'}], ['сырость', {'вин,ед', 'им,ед'}]]
ледяные вихри	[['ледяной', {'вин,мн', 'им,мн'}], ['вихорь', {'вин,мн', 'им,мн'}]]
ледяные скаты	[['ледяной', {'вин,мн', 'им,мн'}], ['скат', {'вин,мн', 'им,мн'}]]
ледяным островом	[['ледяной', {'дат,мн', 'твор,ед'}], ['остров', {'твор,ед'}]]
ледяного света	[['ледяной', {'род,ед', 'вин,ед'}], ['свет', {'род,ед'}]]
ледяной покровъ	[['ледяной', {'твор,ед', 'пр,ед', 'дат,ед', 'им,ед', 'род,ед', 'вин,ед'}], ['покров', {'вин,ед', 'им,ед'}]]
ледяное окно	[['ледяной', {'вин,ед', 'им,ед'}], ['окно', {'вин,ед', 'им,ед'}]]
ледяными оковами	[['ледяной', {'твор,мн'}], ['окова', {'твор,мн'}]]
ледяные закрайки	[['ледяной', {'вин,мн', 'им,мн'}], ['закраек', {'вин,мн', 'им,мн'}]]
ледяной кристалл	[['ледяной', {'твор,ед', 'пр,ед', 'дат,ед', 'им,ед', 'род,ед', 'вин,ед'}], ['кристалл', {'вин,ед', 'им,ед'}]]
ледяными волнами	[['ледяной', {'твор,мн'}], ['волна', {'твор,мн'}]]
ледяной зоне	[['ледяной', {'твор,ед', 'пр,ед', 'дат,ед', 'им,ед', 'род,ед', 'вин,ед'}], ['зона', {'дат,ед', 'пр,ед'}]]
ледяную пробку	[['ледяной', {'вин,ед'}], ['пробка', {'вин,ед'}]]
ледяным походом	[['ледяной', {'дат,мн', 'твор,ед'}], ['поход', {'твор,ед'}]]
ледяной ловушки	[['ледяной', {'твор,ед', 'пр,ед', 'дат,ед', 'им,ед', 'род,ед', 'вин,ед'}], ['ловушка', {'вин,мн', 'род,ед', 'им,мн'}]]
ледяных морей	[['ледяной', {'пр,мн', 'род,мн', 'вин,мн'}], ['море', {'род,мн'}]]
ледяные порывы	[['ледяной', {'вин,мн', 'им,мн'}], ['порыв', {'вин,мн', 'им,мн'}]]
ледяной хребет	[['ледяной', {'твор,ед', 'пр,ед', 'дат,ед', 'им,ед', 'род,ед', 'вин,ед'}], ['хребет', {'вин,ед', 'им,ед'}]]
ледяная прорубь	[['ледяной', {'им,ед'}], ['прорубь', {'вин,ед', 'им,ед'}]]
ледяных судорог	[['ледяной', {'пр,мн', 'род,мн', 'вин,мн'}], ['судорога', {'род,мн'}]]
ледяных балок	[['ледяной', {'пр,мн', 'род,мн', 'вин,мн'}], ['балка', {'род,мн'}]]
ледяная кора	[['ледяной', {'им,ед'}], ['кора', {'им,ед'}]]
ледяные звезды	[['ледяной', {'вин,мн', 'им,мн'}], ['звезда', {'вин,мн', 'род,ед', 'им,мн'}]]
ледяных кочках	[['ледяной', {'пр,мн', 'род,мн', 'вин,мн'}], ['кочка', {'пр,мн'}]]
ледяной волне	[['ледяной', {'твор,ед', 'пр,ед', 'дат,ед', 'им,ед', 'род,ед', 'вин,ед'}], ['волна', {'дат,ед', 'пр,ед'}]]
ледяными водами	[['ледяной', {'твор,мн'}], ['вод', {'твор,мн'}]]
ледяного аэродрома	[['ледяной', {'род,ед', 'вин,ед'}], ['аэродром', {'род,ед'}]]
ледяных щитов	[['ледяной', {'пр,мн', 'род,мн', 'вин,мн'}], ['щит', {'род,мн'}]]
ледяной рукой	[['ледяной', {'твор,ед', 'пр,ед', 'дат,ед', 'им,ед', 'род,ед', 'вин,ед'}], ['рука', {'твор,ед'}]]
ледяной горой	[['ледяной', {'твор,ед', 'пр,ед', 'дат,ед', 'им,ед', 'род,ед', 'вин,ед'}], ['гора', {'твор,ед'}]]
ледяной сугроб	[['ледяной', {'твор,ед', 'пр,ед', 'дат,ед', 'им,ед', 'род,ед', 'вин,ед'}], ['сугроб', {'вин,ед', 'им,ед'}]]
ледяную свежесть	[['ледяной', {'вин,ед'}], ['свежесть', {'вин,ед', 'им,ед'}]]
ледяные корочки	[['ледяной', {'вин,мн', 'им,мн'}], ['корочка', {'вин,мн', 'род,ед', 'им,мн'}]]
ледяные башни	[['ледяной', {'вин,мн', 'им,мн'}], ['башня', {'вин,мн', 'род,ед', 'им,мн'}]]
ледяным дном	[['ледяной', {'дат,мн', 'твор,ед'}], ['дно', {'твор,ед'}]]
ледяная стужа	[['ледяной', {'им,ед'}], ['стужа', {'им,ед'}]]
ледяное поле	[['ледяной', {'вин,ед', 'им,ед'}], ['поле', {'пр,ед', 'вин,ед', 'им,ед'}]]
ледяной глоток	[['ледяной', {'твор,ед', 'пр,ед', 'дат,ед', 'им,ед', 'род,ед', 'вин,ед'}], ['глоток', {'вин,ед', 'им,ед'}]]
ледяным горам	[['ледяной', {'дат,мн', 'твор,ед'}], ['гора', {'дат,мн'}]]
ледяные лужи	[['ледяной', {'вин,мн', 'им,мн'}], ['лужа', {'вин,мн', 'род,ед', 'им,мн'}]]
ледяными ночами	[['ледяной', {'твор,мн'}], ['ночь', {'твор,мн'}]]
ледяной пласт	[['ледяной', {'твор,ед', 'пр,ед', 'дат,ед', 'им,ед', 'род,ед', 'вин,ед'}], ['пласт', {'вин,ед', 'им,ед'}]]
ледяных частичек	[['ледяной', {'пр,мн', 'род,мн', 'вин,мн'}], ['частичка', {'род,мн'}]]
ледяной кипяток	[['ледяной', {'твор,ед', 'пр,ед', 'дат,ед', 'им,ед', 'род,ед', 'вин,ед'}], ['кипяток', {'вин,ед', 'им,ед'}]]
ледяной престол	[['ледяной', {'твор,ед', 'пр,ед', 'дат,ед', 'им,ед', 'род,ед', 'вин,ед'}], ['престол', {'вин,ед', 'им,ед'}]]
ледяную громаду	[['ледяной', {'вин,ед'}], ['громада', {'вин,ед'}]]
ледяные прожилки	[['ледяной', {'вин,мн', 'им,мн'}], ['прожилка', {'вин,мн', 'род,ед', 'им,мн'}]]
ледяного пространства	[['ледяной', {'род,ед', 'вин,ед'}], ['пространство', {'вин,мн', 'род,ед', 'им,мн'}]]
ледяную решетку	[['ледяной', {'вин,ед'}], ['решетка', {'вин,ед'}]]
ледяные стены	[['ледяной', {'вин,мн', 'им,мн'}], ['стена', {'вин,мн', 'род,ед', 'им,мн'}]]
ледяное образование	[['ледяной', {'вин,ед', 'им,ед'}], ['образование', {'вин,ед', 'им,ед'}]]
ледяной уксус	[['ледяной', {'твор,ед', 'пр,ед', 'дат,ед', 'им,ед', 'род,ед', 'вин,ед'}], ['уксус', {'вин,ед', 'им,ед'}]]
ледяная дорожка	[['ледяной', {'им,ед'}], ['дорожка', {'им,ед'}]]
ледяные воды	[['ледяной', {'вин,мн', 'им,мн'}], ['вода', {'вин,мн', 'род,ед', 'им,мн'}]]
ледяную баню	[['ледяной', {'вин,ед'}], ['баня', {'вин,ед'}]]
ледяной корке	[['ледяной', {'твор,ед', 'пр,ед', 'дат,ед', 'им,ед', 'род,ед', 'вин,ед'}], ['корка', {'дат,ед', 'пр,ед'}]]
ледяной колодец	[['ледяной', {'твор,ед', 'пр,ед', 'дат,ед', 'им,ед', 'род,ед', 'вин,ед'}], ['колодец', {'вин,ед', 'им,ед'}]]
ледяном покрове	[['ледяной', {'пр,ед'}], ['покров', {'пр,ед'}]]
ледяной пластины	[['ледяной', {'твор,ед', 'пр,ед', 'дат,ед', 'им,ед', 'род,ед', 'вин,ед'}], ['пластина', {'вин,мн', 'род,ед', 'им,мн'}]]
ледяную могилу	[['ледяной', {'вин,ед'}], ['могила', {'вин,ед'}]]
ледяных оковах	[['ледяной', {'пр,мн', 'род,мн', 'вин,мн'}], ['оковы', {'пр,мн'}]]
ледяную постель	[['ледяной', {'вин,ед'}], ['постель', {'вин,ед', 'им,ед'}]]
ледяных щитах	[['ледяной', {'пр,мн', 'род,мн', 'вин,мн'}], ['щит', {'пр,мн'}]]
ледяной кислоты	[['ледяной', {'твор,ед', 'пр,ед', 'дат,ед', 'им,ед', 'род,ед', 'вин,ед'}], ['кислота', {'вин,мн', 'род,ед', 'им,мн'}]]
ледяной брони	[['ледяной', {'твор,ед', 'пр,ед', 'дат,ед', 'им,ед', 'род,ед', 'вин,ед'}], ['броня', {'вин,мн', 'род,ед', 'им,мн'}]]
ледяную ловушку	[['ледяной', {'вин,ед'}], ['ловушка', {'вин,ед'}]]
ледяной стихии	[['ледяной', {'твор,ед', 'пр,ед', 'дат,ед', 'им,ед', 'род,ед', 'вин,ед'}], ['стихия', {'вин,мн', 'дат,ед', 'пр,ед', 'род,ед', 'им,мн'}]]
ледяном безмолвии	[['ледяной', {'пр,ед'}], ['безмолвие', {'пр,ед'}]]
ледяной зимы	[['ледяной', {'твор,ед', 'пр,ед', 'дат,ед', 'им,ед', 'род,ед', 'вин,ед'}], ['зима', {'вин,мн', 'род,ед', 'им,мн'}]]
ледяного зародыша	[['ледяной', {'род,ед', 'вин,ед'}], ['зародыш', {'род,ед'}]]
ледяного дыхания	[['ледяной', {'род,ед', 'вин,ед'}], ['дыхание', {'вин,мн', 'род,ед', 'им,мн'}]]
ледяной Арктики	[['ледяной', {'твор,ед', 'пр,ед', 'дат,ед', 'им,ед', 'род,ед', 'вин,ед'}], ['арктика', {'род,ед'}]]
ледяные пространства	[['ледяной', {'вин,мн', 'им,мн'}], ['пространство', {'вин,мн', 'род,ед', 'им,мн'}]]
ледяная прослойка	[['ледяной', {'им,ед'}], ['прослойка', {'им,ед'}]]
ледяные розы	[['ледяной', {'вин,мн', 'им,мн'}], ['роза', {'вин,мн', 'род,ед', 'им,мн'}]]
ледяные стенки	[['ледяной', {'вин,мн', 'им,мн'}], ['стенка', {'вин,мн', 'род,ед', 'им,мн'}]]
ледяными оболочками	[['ледяной', {'твор,мн'}], ['оболочка', {'твор,мн'}]]
ледяной полосы	[['ледяной', {'твор,ед', 'пр,ед', 'дат,ед', 'им,ед', 'род,ед', 'вин,ед'}], ['полоса', {'вин,мн', 'род,ед', 'им,мн'}]]
ледяное полотно	[['ледяной', {'вин,ед', 'им,ед'}], ['полотно', {'вин,ед', 'им,ед'}]]
ледяного сердца	[['ледяной', {'род,ед', 'вин,ед'}], ['сердце', {'вин,мн', 'род,ед', 'им,мн'}]]
ледяные штормы	[['ледяной', {'вин,мн', 'им,мн'}], ['шторм', {'вин,мн', 'им,мн'}]]
ледяная броня	[['ледяной', {'им,ед'}], ['броня', {'им,ед'}]]
ледяными корками	[['ледяной', {'твор,мн'}], ['корка', {'твор,мн'}]]
ледяных обрывов	[['ледяной', {'пр,мн', 'род,мн', 'вин,мн'}], ['обрыв', {'род,мн'}]]
ледяных хранилищ	[['ледяной', {'пр,мн', 'род,мн', 'вин,мн'}], ['хранилище', {'род,мн'}]]
ледяная вода	[['ледяной', {'им,ед'}], ['вода', {'им,ед'}]]
ледяной холм	[['ледяной', {'твор,ед', 'пр,ед', 'дат,ед', 'им,ед', 'род,ед', 'вин,ед'}], ['холм', {'вин,ед', 'им,ед'}]]
ледяные катки	[['ледяной', {'вин,мн', 'им,мн'}], ['каток', {'вин,мн', 'им,мн'}]]
ледяная пустота	[['ледяной', {'им,ед'}], ['пустота', {'им,ед'}]]
ледяную душу	[['ледяной', {'вин,ед'}], ['душа', {'вин,ед'}]]
ледяной крепости	[['ледяной', {'твор,ед', 'пр,ед', 'дат,ед', 'им,ед', 'род,ед', 'вин,ед'}], ['крепость', {'вин,мн', 'дат,ед', 'пр,ед', 'род,ед', 'им,мн'}]]
ледяная гряда	[['ледяной', {'им,ед'}], ['гряда', {'им,ед'}]]
ледяными поцелуями	[['ледяной', {'твор,мн'}], ['поцелуй', {'твор,мн'}]]
ледяным лицом	[['ледяной', {'дат,мн', 'твор,ед'}], ['лицо', {'твор,ед'}]]
ледяную корку	[['ледяной', {'вин,ед'}], ['корка', {'вин,ед'}]]
ледяной монолит	[['ледяной', {'твор,ед', 'пр,ед', 'дат,ед', 'им,ед', 'род,ед', 'вин,ед'}], ['монолит', {'вин,ед', 'им,ед'}]]
ледяной вихрь	[['ледяной', {'твор,ед', 'пр,ед', 'дат,ед', 'им,ед', 'род,ед', 'вин,ед'}], ['вихорь', {'вин,ед', 'им,ед'}]]
ледяному острову	[['ледяной', {'дат,ед'}], ['остров', {'дат,ед'}]]
ледяное сияние	[['ледяной', {'вин,ед', 'им,ед'}], ['сияние', {'вин,ед', 'им,ед'}]]
ледяные жилки	[['ледяной', {'вин,мн', 'им,мн'}], ['жилка', {'вин,мн', 'род,ед', 'им,мн'}]]
ледяной водою	[['ледяной', {'твор,ед', 'пр,ед', 'дат,ед', 'им,ед', 'род,ед', 'вин,ед'}], ['вода', {'твор,ед'}]]
ледяной зоны	[['ледяной', {'твор,ед', 'пр,ед', 'дат,ед', 'им,ед', 'род,ед', 'вин,ед'}], ['зона', {'вин,мн', 'род,ед', 'им,мн'}]]
ледяной домъ	[['ледяной', {'твор,ед', 'пр,ед', 'дат,ед', 'им,ед', 'род,ед', 'вин,ед'}], ['дом', {'вин,ед', 'им,ед'}]]
ледяной туман	[['ледяной', {'твор,ед', 'пр,ед', 'дат,ед', 'им,ед', 'род,ед', 'вин,ед'}], ['туман', {'вин,ед', 'им,ед'}]]
ледяной глыбы	[['ледяной', {'твор,ед', 'пр,ед', 'дат,ед', 'им,ед', 'род,ед', 'вин,ед'}], ['глыба', {'вин,мн', 'род,ед', 'им,мн'}]]
ледяной скат	[['ледяной', {'твор,ед', 'пр,ед', 'дат,ед', 'им,ед', 'род,ед', 'вин,ед'}], ['скат', {'вин,ед', 'им,ед'}]]
ледяной чаши	[['ледяной', {'твор,ед', 'пр,ед', 'дат,ед', 'им,ед', 'род,ед', 'вин,ед'}], ['чаша', {'вин,мн', 'род,ед', 'им,мн'}]]
ледяные птицы	[['ледяной', {'вин,мн', 'им,мн'}], ['птица', {'род,ед', 'им,мн'}]]
ледяными ветрами	[['ледяной', {'твор,мн'}], ['ветер', {'твор,мн'}]]
ледяной шапке	[['ледяной', {'твор,ед', 'пр,ед', 'дат,ед', 'им,ед', 'род,ед', 'вин,ед'}], ['шапка', {'дат,ед', 'пр,ед'}]]
ледяными шапками	[['ледяной', {'твор,мн'}], ['шапка', {'твор,мн'}]]
ледяной припай	[['ледяной', {'твор,ед', 'пр,ед', 'дат,ед', 'им,ед', 'род,ед', 'вин,ед'}], ['припай', {'вин,ед', 'им,ед'}]]
ледяная смерть	[['ледяной', {'им,ед'}], ['смерть', {'вин,ед', 'им,ед'}]]
ледяным звоном	[['ледяной', {'дат,мн', 'твор,ед'}], ['звон', {'твор,ед'}]]
ледяною водою	[['ледяной', {'твор,ед'}], ['вода', {'твор,ед'}]]
ледяной водопад	[['ледяной', {'твор,ед', 'пр,ед', 'дат,ед', 'им,ед', 'род,ед', 'вин,ед'}], ['водопад', {'вин,ед', 'им,ед'}]]
ледяного уступа	[['ледяной', {'род,ед', 'вин,ед'}], ['уступ', {'род,ед'}]]
ледяные реки	[['ледяной', {'вин,мн', 'им,мн'}], ['река', {'вин,мн', 'род,ед', 'им,мн'}]]
ледяной глубине	[['ледяной', {'твор,ед', 'пр,ед', 'дат,ед', 'им,ед', 'род,ед', 'вин,ед'}], ['глубина', {'дат,ед', 'пр,ед'}]]
ледяные кубики	[['ледяной', {'вин,мн', 'им,мн'}], ['кубик', {'вин,мн', 'им,мн'}]]
ледяного купания	[['ледяной', {'род,ед', 'вин,ед'}], ['купание', {'вин,мн', 'род,ед', 'им,мн'}]]
ледяному куполу	[['ледяной', {'дат,ед'}], ['купол', {'дат,ед'}]]
ледяным телом	[['ледяной', {'дат,мн', 'твор,ед'}], ['тело', {'твор,ед'}]]
ледяное дуло	[['ледяной', {'вин,ед', 'им,ед'}], ['дуло', {'вин,ед', 'им,ед'}]]
ледяных скоплений	[['ледяной', {'пр,мн', 'род,мн', 'вин,мн'}], ['скопление', {'род,мн'}]]
ледяного берега	[['ледяной', {'род,ед', 'вин,ед'}], ['берег', {'вин,мн', 'род,ед', 'им,мн'}]]
ледяные гребни	[['ледяной', {'вин,мн', 'им,мн'}], ['гребень', {'вин,мн', 'им,мн'}]]
ледяной свежестью	[['ледяной', {'твор,ед', 'пр,ед', 'дат,ед', 'им,ед', 'род,ед', 'вин,ед'}], ['свежесть', {'твор,ед'}]]
ледяными барьерами	[['ледяной', {'твор,мн'}], ['барьер', {'твор,мн'}]]
ледяной ванне	[['ледяной', {'твор,ед', 'пр,ед', 'дат,ед', 'им,ед', 'род,ед', 'вин,ед'}], ['ванна', {'дат,ед', 'пр,ед'}]]
ледяное изваяние	[['ледяной', {'вин,ед', 'им,ед'}], ['изваяние', {'вин,ед', 'им,ед'}]]
ледяного ужаса	[['ледяной', {'род,ед', 'вин,ед'}], ['ужас', {'род,ед'}]]
ледяные крошки	[['ледяной', {'вин,мн', 'им,мн'}], ['крошка', {'вин,мн', 'род,ед', 'им,мн'}]]
ледяных осколках	[['ледяной', {'пр,мн', 'род,мн', 'вин,мн'}], ['осколок', {'пр,мн'}]]
ледяное пламя	[['ледяной', {'вин,ед', 'им,ед'}], ['пламень', {'вин,ед', 'им,ед'}]]
ледяные преграды	[['ледяной', {'вин,мн', 'им,мн'}], ['преграда', {'вин,мн', 'род,ед', 'им,мн'}]]
ледяных берегах	[['ледяной', {'пр,мн', 'род,мн', 'вин,мн'}], ['берег', {'пр,мн'}]]
ледяная чаша	[['ледяной', {'им,ед'}], ['чаша', {'им,ед'}]]
ледяные дни	[['ледяной', {'вин,мн', 'им,мн'}], ['день', {'вин,мн', 'им,мн'}]]
ледяными щитами	[['ледяной', {'твор,мн'}], ['щит', {'твор,мн'}]]
ледяного эфира	[['ледяной', {'род,ед', 'вин,ед'}], ['эфир', {'род,ед'}]]
ледяного колодца	[['ледяной', {'род,ед', 'вин,ед'}], ['колодец', {'род,ед'}]]
ледяная слеза	[['ледяной', {'им,ед'}], ['слеза', {'им,ед'}]]
ледяными губами	[['ледяной', {'твор,мн'}], ['губа', {'твор,мн'}]]
ледяной ток	[['ледяной', {'твор,ед', 'пр,ед', 'дат,ед', 'им,ед', 'род,ед', 'вин,ед'}], ['ток', {'вин,ед', 'им,ед'}]]
ледяного прикосновения	[['ледяной', {'род,ед', 'вин,ед'}], ['прикосновение', {'вин,мн', 'род,ед', 'им,мн'}]]
ледяных залежей	[['ледяной', {'пр,мн', 'род,мн', 'вин,мн'}], ['залежи', {'род,мн'}]]
ледяным градом	[['ледяной', {'дат,мн', 'твор,ед'}], ['град', {'твор,ед'}]]
ледяной толще	[['ледяной', {'твор,ед', 'пр,ед', 'дат,ед', 'им,ед', 'род,ед', 'вин,ед'}], ['толща', {'дат,ед', 'пр,ед'}]]
ледяной пустыне	[['ледяной', {'твор,ед', 'пр,ед', 'дат,ед', 'им,ед', 'род,ед', 'вин,ед'}], ['пустыня', {'дат,ед', 'пр,ед'}]]
ледяными плитами	[['ледяной', {'твор,мн'}], ['плита', {'твор,мн'}]]
ледяном русле	[['ледяной', {'пр,ед'}], ['русло', {'пр,ед'}]]
ледяное ложе	[['ледяной', {'вин,ед', 'им,ед'}], ['ложе', {'пр,ед', 'вин,ед', 'им,ед'}]]
ледяной островъ	[['ледяной', {'твор,ед', 'пр,ед', 'дат,ед', 'им,ед', 'род,ед', 'вин,ед'}], ['остров', {'вин,ед', 'им,ед'}]]
ледяных пушек	[['ледяной', {'пр,мн', 'род,мн', 'вин,мн'}], ['пушка', {'род,мн'}]]
ледяных слоях	[['ледяной', {'пр,мн', 'род,мн', 'вин,мн'}], ['слой', {'пр,мн'}]]
ледяного столба	[['ледяной', {'род,ед', 'вин,ед'}], ['столб', {'род,ед'}]]
ледяной корою	[['ледяной', {'твор,ед', 'пр,ед', 'дат,ед', 'им,ед', 'род,ед', 'вин,ед'}], ['кора', {'твор,ед'}]]
ледяного вала	[['ледяной', {'род,ед', 'вин,ед'}], ['вал', {'род,ед'}]]
ледяной уступ	[['ледяной', {'твор,ед', 'пр,ед', 'дат,ед', 'им,ед', 'род,ед', 'вин,ед'}], ['уступ', {'вин,ед', 'им,ед'}]]
ледяному полу	[['ледяной', {'дат,ед'}], ['пол', {'дат,ед', 'местн,ед'}]]
ледяными массами	[['ледяной', {'твор,мн'}], ['масса', {'твор,мн'}]]
ледяные ладоши	[['ледяной', {'вин,мн', 'им,мн'}], ['ладоши', {'вин,мн', 'им,мн'}]]
ледяные склады	[['ледяной', {'вин,мн', 'им,мн'}], ['склад', {'вин,мн', 'им,мн'}]]
ледяное молоко	[['ледяной', {'вин,ед', 'им,ед'}], ['молоко', {'вин,ед', 'им,ед'}]]
ледяные цветы	[['ледяной', {'вин,мн', 'им,мн'}], ['цветок', {'вин,мн', 'им,мн'}]]
ледяной ванны	[['ледяной', {'твор,ед', 'пр,ед', 'дат,ед', 'им,ед', 'род,ед', 'вин,ед'}], ['ванна', {'вин,мн', 'род,ед', 'им,мн'}]]
ледяную жижу	[['ледяной', {'вин,ед'}], ['жижа', {'вин,ед'}]]
ледяные площадки	[['ледяной', {'вин,мн', 'им,мн'}], ['площадка', {'вин,мн', 'род,ед', 'им,мн'}]]
ледяным холодком	[['ледяной', {'дат,мн', 'твор,ед'}], ['холодок', {'твор,ед'}]]
ледяной страны	[['ледяной', {'твор,ед', 'пр,ед', 'дат,ед', 'им,ед', 'род,ед', 'вин,ед'}], ['страна', {'вин,мн', 'род,ед', 'им,мн'}]]
ледяная шапка	[['ледяной', {'им,ед'}], ['шапка', {'им,ед'}]]
ледяной его	[['ледяной', {'твор,ед', 'пр,ед', 'дат,ед', 'им,ед', 'род,ед', 'вин,ед'}], ['он', {'род,ед', 'вин,ед'}]]
ледяными пиками	[['ледяной', {'твор,мн'}], ['пик', {'твор,мн'}]]
ледяной площадки	[['ледяной', {'твор,ед', 'пр,ед', 'дат,ед', 'им,ед', 'род,ед', 'вин,ед'}], ['площадка', {'вин,мн', 'род,ед', 'им,мн'}]]
ледяных полях	[['ледяной', {'пр,мн', 'род,мн', 'вин,мн'}], ['поле', {'пр,мн'}]]
ледяная шуга	[['ледяной', {'им,ед'}], ['шуга', {'им,ед'}]]
ледяной прием	[['ледяной', {'твор,ед', 'пр,ед', 'дат,ед', 'им,ед', 'род,ед', 'вин,ед'}], ['прием', {'вин,ед', 'им,ед'}]]
ледяных дорожках	[['ледяной', {'пр,мн', 'род,мн', 'вин,мн'}], ['дорожка', {'пр,мн'}]]
ледяные гроты	[['ледяной', {'вин,мн', 'им,мн'}], ['грот', {'вин,мн', 'им,мн'}]]
ледяную лужу	[['ледяной', {'вин,ед'}], ['лужа', {'вин,ед'}]]
ледяные замки	[['ледяной', {'вин,мн', 'им,мн'}], ['замок', {'вин,мн', 'им,мн'}]]
ледяных звезд	[['ледяной', {'пр,мн', 'род,мн', 'вин,мн'}], ['звезда', {'род,мн'}]]
ледяной комнате	[['ледяной', {'твор,ед', 'пр,ед', 'дат,ед', 'им,ед', 'род,ед', 'вин,ед'}], ['комната', {'дат,ед', 'пр,ед'}]]
ледяную переправу	[['ледяной', {'вин,ед'}], ['переправа', {'вин,ед'}]]
ледяной океан	[['ледяной', {'твор,ед', 'пр,ед', 'дат,ед', 'им,ед', 'род,ед', 'вин,ед'}], ['океан', {'вин,ед', 'им,ед'}]]
ледяные пушки	[['ледяной', {'вин,мн', 'им,мн'}], ['пушка', {'вин,мн', 'род,ед', 'им,мн'}]]
ледяные кружева	[['ледяной', {'вин,мн', 'им,мн'}], ['кружева', {'вин,мн', 'им,мн'}]]
ледяной водицей	[['ледяной', {'твор,ед', 'пр,ед', 'дат,ед', 'им,ед', 'род,ед', 'вин,ед'}], ['водица', {'твор,ед'}]]
ледяной тяжестью	[['ледяной', {'твор,ед', 'пр,ед', 'дат,ед', 'им,ед', 'род,ед', 'вин,ед'}], ['тяжесть', {'твор,ед'}]]
ледяная горка	[['ледяной', {'им,ед'}], ['горка', {'им,ед'}]]
ледяную кору	[['ледяной', {'вин,ед'}], ['кора', {'вин,ед'}]]
ледяного покро	[['ледяной', {'род,ед', 'вин,ед'}], ['покро', set()]]
ледяного ветра	[['ледяной', {'род,ед', 'вин,ед'}], ['ветер', {'вин,мн', 'род,ед', 'им,мн'}]]
ледяных просторах	[['ледяной', {'пр,мн', 'род,мн', 'вин,мн'}], ['простор', {'пр,мн'}]]
ледяным ливнем	[['ледяной', {'дат,мн', 'твор,ед'}], ['ливень', {'твор,ед'}]]
ледяного покрова	[['ледяной', {'род,ед', 'вин,ед'}], ['покров', {'род,ед'}]]
ледяных широт	[['ледяной', {'пр,мн', 'род,мн', 'вин,мн'}], ['широта', {'род,мн'}]]
ледяного пива	[['ледяной', {'род,ед', 'вин,ед'}], ['пиво', {'род,ед'}]]
ледяные камни	[['ледяной', {'вин,мн', 'им,мн'}], ['камень', {'вин,мн', 'им,мн'}]]
ледяной пылью	[['ледяной', {'твор,ед', 'пр,ед', 'дат,ед', 'им,ед', 'род,ед', 'вин,ед'}], ['пыль', {'твор,ед'}]]
ледяной кольчугой	[['ледяной', {'твор,ед', 'пр,ед', 'дат,ед', 'им,ед', 'род,ед', 'вин,ед'}], ['кольчуга', {'твор,ед'}]]
ледяной трассы	[['ледяной', {'твор,ед', 'пр,ед', 'дат,ед', 'им,ед', 'род,ед', 'вин,ед'}], ['трасса', {'вин,мн', 'род,ед', 'им,мн'}]]
ледяными пальцами	[['ледяной', {'твор,мн'}], ['палец', {'твор,мн'}]]
ледяных образцов	[['ледяной', {'пр,мн', 'род,мн', 'вин,мн'}], ['образец', {'род,мн'}]]
ледяные торосы	[['ледяной', {'вин,мн', 'им,мн'}], ['торос', {'вин,мн', 'им,мн'}]]
ледяная крупа	[['ледяной', {'им,ед'}], ['крупа', {'им,ед'}]]
ледяным воздухом	[['ледяной', {'дат,мн', 'твор,ед'}], ['воздух', {'твор,ед'}]]
ледяной яростью	[['ледяной', {'твор,ед', 'пр,ед', 'дат,ед', 'им,ед', 'род,ед', 'вин,ед'}], ['ярость', {'твор,ед'}]]
ледяную стену	[['ледяной', {'вин,ед'}], ['стена', {'вин,ед'}]]
ледяных кристаллов	[['ледяной', {'пр,мн', 'род,мн', 'вин,мн'}], ['кристалл', {'род,мн'}]]
ледяными слоями	[['ледяной', {'твор,мн'}], ['слой', {'твор,мн'}]]
ледяной стены	[['ледяной', {'твор,ед', 'пр,ед', 'дат,ед', 'им,ед', 'род,ед', 'вин,ед'}], ['стена', {'вин,мн', 'род,ед', 'им,мн'}]]
ледяного бугра	[['ледяной', {'род,ед', 'вин,ед'}], ['бугор', {'род,ед'}]]
ледяного океана	[['ледяной', {'род,ед', 'вин,ед'}], ['океан', {'род,ед'}]]
ледяной стужи	[['ледяной', {'твор,ед', 'пр,ед', 'дат,ед', 'им,ед', 'род,ед', 'вин,ед'}], ['стужа', {'вин,мн', 'род,ед', 'им,мн'}]]
ледяной корочке	[['ледяной', {'твор,ед', 'пр,ед', 'дат,ед', 'им,ед', 'род,ед', 'вин,ед'}], ['корочка', {'дат,ед', 'пр,ед'}]]
ледяной синеве	[['ледяной', {'твор,ед', 'пр,ед', 'дат,ед', 'им,ед', 'род,ед', 'вин,ед'}], ['синева', {'дат,ед', 'пр,ед'}]]
ледяные ручьи	[['ледяной', {'вин,мн', 'им,мн'}], ['ручей', {'вин,мн', 'им,мн'}]]
ледяной гребень	[['ледяной', {'твор,ед', 'пр,ед', 'дат,ед', 'им,ед', 'род,ед', 'вин,ед'}], ['гребень', {'вин,ед', 'им,ед'}]]
ледяными сердцами	[['ледяной', {'твор,мн'}], ['сердце', {'твор,мн'}]]
ледяной коросте	[['ледяной', {'твор,ед', 'пр,ед', 'дат,ед', 'им,ед', 'род,ед', 'вин,ед'}], ['короста', {'дат,ед', 'пр,ед'}]]
ледяной купелью	[['ледяной', {'твор,ед', 'пр,ед', 'дат,ед', 'им,ед', 'род,ед', 'вин,ед'}], ['купель', {'твор,ед'}]]
ледяным молоком	[['ледяной', {'дат,мн', 'твор,ед'}], ['молоко', {'твор,ед'}]]
ледяную лавину	[['ледяной', {'вин,ед'}], ['лавина', {'вин,ед'}]]
ледяной хрусталь	[['ледяной', {'твор,ед', 'пр,ед', 'дат,ед', 'им,ед', 'род,ед', 'вин,ед'}], ['хрусталь', {'вин,ед', 'им,ед'}]]
ледяными походами	[['ледяной', {'твор,мн'}], ['поход', {'твор,мн'}]]
ледяные бревна	[['ледяной', {'вин,мн', 'им,мн'}], ['бревно', {'вин,мн', 'род,ед', 'им,мн'}]]
ледяных платформ	[['ледяной', {'пр,мн', 'род,мн', 'вин,мн'}], ['платформа', {'род,мн'}]]
ледяные зародыши	[['ледяной', {'вин,мн', 'им,мн'}], ['зародыш', {'вин,мн', 'им,мн'}]]
ледяной клин	[['ледяной', {'твор,ед', 'пр,ед', 'дат,ед', 'им,ед', 'род,ед', 'вин,ед'}], ['клин', {'вин,ед', 'им,ед'}]]
ледяное чувство	[['ледяной', {'вин,ед', 'им,ед'}], ['чувство', {'вин,ед', 'им,ед'}]]
ледяной наст	[['ледяной', {'твор,ед', 'пр,ед', 'дат,ед', 'им,ед', 'род,ед', 'вин,ед'}], ['наст', {'вин,ед', 'им,ед'}]]
ледяной уксусной	[['ледяной', {'твор,ед', 'пр,ед', 'дат,ед', 'им,ед', 'род,ед', 'вин,ед'}], ['уксусный', set()]]
ледяную зиму	[['ледяной', {'вин,ед'}], ['зима', {'вин,ед'}]]
ледяные брызги	[['ледяной', {'вин,мн', 'им,мн'}], ['брызги', {'вин,мн', 'им,мн'}]]
ледяном мраке	[['ледяной', {'пр,ед'}], ['мрак', {'пр,ед'}]]
ледяным небом	[['ледяной', {'дат,мн', 'твор,ед'}], ['небо', {'твор,ед'}]]
ледяному простору	[['ледяной', {'дат,ед'}], ['простор', {'дат,ед', 'парт,ед'}]]
ледяною коркой	[['ледяной', {'твор,ед'}], ['корка', {'твор,ед'}]]
ледяных дорог	[['ледяной', {'пр,мн', 'род,мн', 'вин,мн'}], ['дорога', {'род,мн'}]]
ледяных глыб	[['ледяной', {'пр,мн', 'род,мн', 'вин,мн'}], ['глыба', {'род,мн'}]]
ледяной бугор	[['ледяной', {'твор,ед', 'пр,ед', 'дат,ед', 'им,ед', 'род,ед', 'вин,ед'}], ['бугор', {'вин,ед', 'им,ед'}]]
ледяной твердостью	[['ледяной', {'твор,ед', 'пр,ед', 'дат,ед', 'им,ед', 'род,ед', 'вин,ед'}], ['твердость', {'твор,ед'}]]
ледяной пробкой	[['ледяной', {'твор,ед', 'пр,ед', 'дат,ед', 'им,ед', 'род,ед', 'вин,ед'}], ['пробка', {'твор,ед'}]]
ледяной тюрьмы	[['ледяной', {'твор,ед', 'пр,ед', 'дат,ед', 'им,ед', 'род,ед', 'вин,ед'}], ['тюрьма', {'вин,мн', 'род,ед', 'им,мн'}]]
ледяными дорогами	[['ледяной', {'твор,мн'}], ['дорога', {'твор,мн'}]]
ледяной луч	[['ледяной', {'твор,ед', 'пр,ед', 'дат,ед', 'им,ед', 'род,ед', 'вин,ед'}], ['луч', {'вин,ед', 'им,ед'}]]
ледяными наростами	[['ледяной', {'твор,мн'}], ['нарост', {'твор,мн'}]]
ледяными массивами	[['ледяной', {'твор,мн'}], ['массив', {'твор,мн'}]]
ледяная статуя	[['ледяной', {'им,ед'}], ['статуя', {'им,ед'}]]
ледяной островок	[['ледяной', {'твор,ед', 'пр,ед', 'дат,ед', 'им,ед', 'род,ед', 'вин,ед'}], ['островок', {'вин,ед', 'им,ед'}]]
ледяным видом	[['ледяной', {'дат,мн', 'твор,ед'}], ['вид', {'твор,ед'}]]
ледяную воду	[['ледяной', {'вин,ед'}], ['вода', {'вин,ед'}]]
ледяные ступени	[['ледяной', {'вин,мн', 'им,мн'}], ['ступень', {'вин,мн', 'дат,ед', 'пр,ед', 'род,ед', 'им,мн'}]]
ледяная фаза	[['ледяной', {'им,ед'}], ['фаза', {'им,ед'}]]
ледяному барьеру	[['ледяной', {'дат,ед'}], ['барьер', {'дат,ед'}]]
ледяной слон	[['ледяной', {'твор,ед', 'пр,ед', 'дат,ед', 'им,ед', 'род,ед', 'вин,ед'}], ['слон', {'им,ед'}]]
ледяными облаками	[['ледяной', {'твор,мн'}], ['облако', {'твор,мн'}]]
ледяных стен	[['ледяной', {'пр,мн', 'род,мн', 'вин,мн'}], ['стена', {'род,мн'}]]
ледяными лапами	[['ледяной', {'твор,мн'}], ['лапа', {'твор,мн'}]]
ледяного поля	[['ледяной', {'род,ед', 'вин,ед'}], ['поле', {'вин,мн', 'род,ед', 'им,мн'}]]
ледяные скопления	[['ледяной', {'вин,мн', 'им,мн'}], ['скопление', {'вин,мн', 'род,ед', 'им,мн'}]]
ледяных заторов	[['ледяной', {'пр,мн', 'род,мн', 'вин,мн'}], ['затор', {'род,мн'}]]
ледяными глазами	[['ледяной', {'твор,мн'}], ['глаз', {'твор,мн'}]]
ледяных кристаллах	[['ледяной', {'пр,мн', 'род,мн', 'вин,мн'}], ['кристалл', {'пр,мн'}]]
ледяные частички	[['ледяной', {'вин,мн', 'им,мн'}], ['частичка', {'вин,мн', 'род,ед', 'им,мн'}]]
ледяными иглами	[['ледяной', {'твор,мн'}], ['игла', {'твор,мн'}]]
ледяной горке	[['ледяной', {'твор,ед', 'пр,ед', 'дат,ед', 'им,ед', 'род,ед', 'вин,ед'}], ['горка', {'дат,ед', 'пр,ед'}]]
ледяные ливни	[['ледяной', {'вин,мн', 'им,мн'}], ['ливень', {'вин,мн', 'им,мн'}]]
ледяную маску	[['ледяной', {'вин,ед'}], ['маска', {'вин,ед'}]]
ледяными осколками	[['ледяной', {'твор,мн'}], ['осколок', {'твор,мн'}]]
ледяными громадами	[['ледяной', {'твор,мн'}], ['громада', {'твор,мн'}]]
ледяными клещами	[['ледяной', {'твор,мн'}], ['клещи', {'твор,мн'}]]
ледяную стенку	[['ледяной', {'вин,ед'}], ['стенка', {'вин,ед'}]]
ледяную вежливость	[['ледяной', {'вин,ед'}], ['вежливость', {'вин,ед', 'им,ед'}]]
ледяные пустыни	[['ледяной', {'вин,мн', 'им,мн'}], ['пустыня', {'вин,мн', 'род,ед', 'им,мн'}]]
ледяные ванны	[['ледяной', {'вин,мн', 'им,мн'}], ['ванна', {'вин,мн', 'род,ед', 'им,мн'}]]
ледяным валом	[['ледяной', {'дат,мн', 'твор,ед'}], ['вал', {'твор,ед'}]]
ледяная пленка	[['ледяной', {'им,ед'}], ['пленка', {'им,ед'}]]
ледяных спутников	[['ледяной', {'пр,мн', 'род,мн', 'вин,мн'}], ['спутник', {'род,мн', 'вин,мн'}]]
ледяной корочки	[['ледяной', {'твор,ед', 'пр,ед', 'дат,ед', 'им,ед', 'род,ед', 'вин,ед'}], ['корочка', {'вин,мн', 'род,ед', 'им,мн'}]]
ледяную дорожку	[['ледяной', {'вин,ед'}], ['дорожка', {'вин,ед'}]]
ледяными пустынями	[['ледяной', {'твор,мн'}], ['пустыня', {'твор,мн'}]]
ледяная громада	[['ледяной', {'им,ед'}], ['громада', {'им,ед'}]]
ледяные айсберги	[['ледяной', {'вин,мн', 'им,мн'}], ['айсберг', {'вин,мн', 'им,мн'}]]
ледяное дыхание	[['ледяной', {'вин,ед', 'им,ед'}], ['дыхание', {'вин,ед', 'им,ед'}]]
ледяном городе	[['ледяной', {'пр,ед'}], ['город', {'пр,ед'}]]
ледяной громаде	[['ледяной', {'твор,ед', 'пр,ед', 'дат,ед', 'им,ед', 'род,ед', 'вин,ед'}], ['громада', {'дат,ед', 'пр,ед'}]]
ледяными хребтами	[['ледяной', {'твор,мн'}], ['хребет', {'твор,мн'}]]
ледяной дождь	[['ледяной', {'твор,ед', 'пр,ед', 'дат,ед', 'им,ед', 'род,ед', 'вин,ед'}], ['дождь', {'вин,ед', 'им,ед'}]]
ледяной тишине	[['ледяной', {'твор,ед', 'пр,ед', 'дат,ед', 'им,ед', 'род,ед', 'вин,ед'}], ['тишина', {'дат,ед', 'пр,ед'}]]
ледяной напиток	[['ледяной', {'твор,ед', 'пр,ед', 'дат,ед', 'им,ед', 'род,ед', 'вин,ед'}], ['напиток', {'вин,ед', 'им,ед'}]]
ледяным ознобом	[['ледяной', {'дат,мн', 'твор,ед'}], ['озноб', {'твор,ед'}]]
ледяные ворота	[['ледяной', {'вин,мн', 'им,мн'}], ['ворота', {'вин,мн', 'им,мн'}]]
ледяной дороги	[['ледяной', {'твор,ед', 'пр,ед', 'дат,ед', 'им,ед', 'род,ед', 'вин,ед'}], ['дорога', {'вин,мн', 'род,ед', 'им,мн'}]]
ледяном теле	[['ледяной', {'пр,ед'}], ['тело', {'пр,ед'}]]
ледяной иглой	[['ледяной', {'твор,ед', 'пр,ед', 'дат,ед', 'им,ед', 'род,ед', 'вин,ед'}], ['игла', {'твор,ед'}]]
ледяные якоря	[['ледяной', {'вин,мн', 'им,мн'}], ['якорь', {'вин,мн', 'род,ед', 'им,мн'}]]
ледяном барьере	[['ледяной', {'пр,ед'}], ['барьер', {'пр,ед'}]]
ледяные холмы	[['ледяной', {'вин,мн', 'им,мн'}], ['холм', {'вин,мн', 'им,мн'}]]
ледяной водки	[['ледяной', {'твор,ед', 'пр,ед', 'дат,ед', 'им,ед', 'род,ед', 'вин,ед'}], ['водка', {'вин,мн', 'род,ед', 'им,мн'}]]
ледяной шуги	[['ледяной', {'твор,ед', 'пр,ед', 'дат,ед', 'им,ед', 'род,ед', 'вин,ед'}], ['шуга', {'род,ед'}]]
ледяного блеска	[['ледяной', {'род,ед', 'вин,ед'}], ['блеск', {'род,ед'}]]
ледяную сырость	[['ледяной', {'вин,ед'}], ['сырость', {'вин,ед', 'им,ед'}]]
ледяном острове	[['ледяной', {'пр,ед'}], ['остров', {'пр,ед'}]]
ледяной мороз	[['ледяной', {'твор,ед', 'пр,ед', 'дат,ед', 'им,ед', 'род,ед', 'вин,ед'}], ['мороз', {'вин,ед', 'им,ед'}]]
ледяной изморози	[['ледяной', {'твор,ед', 'пр,ед', 'дат,ед', 'им,ед', 'род,ед', 'вин,ед'}], ['изморозь', {'вин,мн', 'дат,ед', 'пр,ед', 'род,ед', 'им,мн'}]]
ледяные острова	[['ледяной', {'вин,мн', 'им,мн'}], ['остров', {'вин,мн', 'род,ед', 'им,мн'}]]
ледяная пластина	[['ледяной', {'им,ед'}], ['пластина', {'им,ед'}]]
ледяных стенок	[['ледяной', {'пр,мн', 'род,мн', 'вин,мн'}], ['стенка', {'род,мн'}]]
ледяными реками	[['ледяной', {'твор,мн'}], ['река', {'твор,мн'}]]
ледяном пруду	[['ледяной', {'пр,ед'}], ['пруд', {'дат,ед', 'местн,ед'}]]
ледяной озноб	[['ледяной', {'твор,ед', 'пр,ед', 'дат,ед', 'им,ед', 'род,ед', 'вин,ед'}], ['озноб', {'вин,ед', 'им,ед'}]]
ледяными языками	[['ледяной', {'твор,мн'}], ['язык', {'твор,мн'}]]
ледяной глыбой	[['ледяной', {'твор,ед', 'пр,ед', 'дат,ед', 'им,ед', 'род,ед', 'вин,ед'}], ['глыба', {'твор,ед'}]]
ледяной поход	[['ледяной', {'твор,ед', 'пр,ед', 'дат,ед', 'им,ед', 'род,ед', 'вин,ед'}], ['поход', {'вин,ед', 'им,ед'}]]
ледяные сосули	[['ледяной', {'вин,мн', 'им,мн'}], ['сосуля', {'вин,мн', 'род,ед', 'им,мн'}]]
ледяным хаосом	[['ледяной', {'дат,мн', 'твор,ед'}], ['хаос', {'твор,ед'}]]
ледяных выступов	[['ледяной', {'пр,мн', 'род,мн', 'вин,мн'}], ['выступ', {'род,мн'}]]
ледяные сердца	[['ледяной', {'вин,мн', 'им,мн'}], ['сердце', {'вин,мн', 'род,ед', 'им,мн'}]]
ледяную плиту	[['ледяной', {'вин,ед'}], ['плита', {'вин,ед'}]]
ледяные иголки	[['ледяной', {'вин,мн', 'им,мн'}], ['иголка', {'вин,мн', 'род,ед', 'им,мн'}]]
ледяного керна	[['ледяной', {'род,ед', 'вин,ед'}], ['керн', {'род,ед'}]]
ледяной земли	[['ледяной', {'твор,ед', 'пр,ед', 'дат,ед', 'им,ед', 'род,ед', 'вин,ед'}], ['земля', {'вин,мн', 'род,ед', 'им,мн'}]]
ледяную жилу	[['ледяной', {'вин,ед'}], ['жила', {'вин,ед'}]]
ледяной панцирь	[['ледяной', {'твор,ед', 'пр,ед', 'дат,ед', 'им,ед', 'род,ед', 'вин,ед'}], ['панцирь', {'вин,ед', 'им,ед'}]]
ледяным молчанием	[['ледяной', {'дат,мн', 'твор,ед'}], ['молчание', {'твор,ед'}]]
ледяной глазурью	[['ледяной', {'твор,ед', 'пр,ед', 'дат,ед', 'им,ед', 'род,ед', 'вин,ед'}], ['глазурь', {'твор,ед'}]]
ледяной холодностью	[['ледяной', {'твор,ед', 'пр,ед', 'дат,ед', 'им,ед', 'род,ед', 'вин,ед'}], ['холодность', {'твор,ед'}]]
ледяную оболочку	[['ледяной', {'вин,ед'}], ['оболочка', {'вин,ед'}]]
ледяной пластинки	[['ледяной', {'твор,ед', 'пр,ед', 'дат,ед', 'им,ед', 'род,ед', 'вин,ед'}], ['пластинка', {'вин,мн', 'род,ед', 'им,мн'}]]
ледяного огня	[['ледяной', {'род,ед', 'вин,ед'}], ['огонь', {'род,ед'}]]
ледяному обрыву	[['ледяной', {'дат,ед'}], ['обрыв', {'дат,ед'}]]
ледяными брызгами	[['ледяной', {'твор,мн'}], ['брызги', {'твор,мн'}]]
ледяного озноба	[['ледяной', {'род,ед', 'вин,ед'}], ['озноб', {'род,ед'}]]
ледяной испарине	[['ледяной', {'твор,ед', 'пр,ед', 'дат,ед', 'им,ед', 'род,ед', 'вин,ед'}], ['испарина', {'дат,ед', 'пр,ед'}]]
ледяное прикосновение	[['ледяной', {'вин,ед', 'им,ед'}], ['прикосновение', {'вин,ед', 'им,ед'}]]
ледяном шкафу	[['ледяной', {'пр,ед'}], ['шкаф', {'дат,ед', 'местн,ед'}]]
ледяных скалах	[['ледяной', {'пр,мн', 'род,мн', 'вин,мн'}], ['скала', {'пр,мн'}]]
ледяной глыбе	[['ледяной', {'твор,ед', 'пр,ед', 'дат,ед', 'им,ед', 'род,ед', 'вин,ед'}], ['глыба', {'дат,ед', 'пр,ед'}]]
ледяным ветром	[['ледяной', {'дат,мн', 'твор,ед'}], ['ветер', {'твор,ед'}]]
ледяная каша	[['ледяной', {'им,ед'}], ['каша', {'им,ед'}]]
ледяные толщи	[['ледяной', {'вин,мн', 'им,мн'}], ['толща', {'вин,мн', 'род,ед', 'им,мн'}]]
ледяных столбах	[['ледяной', {'пр,мн', 'род,мн', 'вин,мн'}], ['столб', {'пр,мн'}]]
ледяном бугре	[['ледяной', {'пр,ед'}], ['бугор', {'пр,ед'}]]
ледяные берега	[['ледяной', {'вин,мн', 'им,мн'}], ['берег', {'вин,мн', 'род,ед', 'им,мн'}]]
ледяном свете	[['ледяной', {'пр,ед'}], ['свет', {'пр,ед'}]]
ледяных вершинах	[['ледяной', {'пр,мн', 'род,мн', 'вин,мн'}], ['вершина', {'пр,мн'}]]
ледяной он	[['ледяной', {'твор,ед', 'пр,ед', 'дат,ед', 'им,ед', 'род,ед', 'вин,ед'}], ['он', {'им,ед'}]]
ледяные фигуры	[['ледяной', {'вин,мн', 'им,мн'}], ['фигура', {'вин,мн', 'род,ед', 'им,мн'}]]
ледяных тел	[['ледяной', {'пр,мн', 'род,мн', 'вин,мн'}], ['тело', {'род,мн'}]]
ледяные озера	[['ледяной', {'вин,мн', 'им,мн'}], ['озеро', {'вин,мн', 'род,ед', 'им,мн'}]]
ледяных прожилок	[['ледяной', {'пр,мн', 'род,мн', 'вин,мн'}], ['прожилка', {'род,мн'}]]
ледяной иронией	[['ледяной', {'твор,ед', 'пр,ед', 'дат,ед', 'им,ед', 'род,ед', 'вин,ед'}], ['ирония', {'твор,ед'}]]
ледяного наста	[['ледяной', {'род,ед', 'вин,ед'}], ['наст', {'род,ед'}]]
ледяной мост	[['ледяной', {'твор,ед', 'пр,ед', 'дат,ед', 'им,ед', 'род,ед', 'вин,ед'}], ['мост', {'вин,ед', 'им,ед'}]]
ледяное хладнокровие	[['ледяной', {'вин,ед', 'им,ед'}], ['хладнокровие', {'вин,ед', 'им,ед'}]]
ледяной бассейн	[['ледяной', {'твор,ед', 'пр,ед', 'дат,ед', 'им,ед', 'род,ед', 'вин,ед'}], ['бассейн', {'вин,ед', 'им,ед'}]]
ледяное спокойствие	[['ледяной', {'вин,ед', 'им,ед'}], ['спокойствие', {'вин,ед', 'им,ед'}]]
ледяной лапой	[['ледяной', {'твор,ед', 'пр,ед', 'дат,ед', 'им,ед', 'род,ед', 'вин,ед'}], ['лапа', {'твор,ед'}]]
ледяная крыша	[['ледяной', {'им,ед'}], ['крыша', {'им,ед'}]]
ледяного дворца	[['ледяной', {'род,ед', 'вин,ед'}], ['дворец', {'род,ед'}]]
ледяные щиты	[['ледяной', {'вин,мн', 'им,мн'}], ['щит', {'вин,мн', 'им,мн'}]]
ледяная волна	[['ледяной', {'им,ед'}], ['волна', {'им,ед'}]]
ледяными частицами	[['ледяной', {'твор,мн'}], ['частица', {'твор,мн'}]]
ледяные компрессы	[['ледяной', {'вин,мн', 'им,мн'}], ['компресс', {'вин,мн', 'им,мн'}]]
ледяными торосами	[['ледяной', {'твор,мн'}], ['торос', {'твор,мн'}]]
ледяная река	[['ледяной', {'им,ед'}], ['река', {'им,ед'}]]
ледяной перюдъ	[['ледяной', {'твор,ед', 'пр,ед', 'дат,ед', 'им,ед', 'род,ед', 'вин,ед'}], ['перюдо', {'род,мн'}]]
ледяных лавин	[['ледяной', {'пр,мн', 'род,мн', 'вин,мн'}], ['лавина', {'род,мн'}]]
ледяным настом	[['ледяной', {'дат,мн', 'твор,ед'}], ['наст', {'твор,ед'}]]
ледяной конус	[['ледяной', {'твор,ед', 'пр,ед', 'дат,ед', 'им,ед', 'род,ед', 'вин,ед'}], ['конус', {'вин,ед', 'им,ед'}]]
ледяной пустыней	[['ледяной', {'твор,ед', 'пр,ед', 'дат,ед', 'им,ед', 'род,ед', 'вин,ед'}], ['пустыня', {'твор,ед'}]]
ледяной холод	[['ледяной', {'твор,ед', 'пр,ед', 'дат,ед', 'им,ед', 'род,ед', 'вин,ед'}], ['холод', {'вин,ед', 'им,ед'}]]
ледяные ступни	[['ледяной', {'вин,мн', 'им,мн'}], ['ступня', {'вин,мн', 'род,ед', 'им,мн'}]]
ледяной испариной	[['ледяной', {'твор,ед', 'пр,ед', 'дат,ед', 'им,ед', 'род,ед', 'вин,ед'}], ['испарина', {'твор,ед'}]]
ледяной месяц	[['ледяной', {'твор,ед', 'пр,ед', 'дат,ед', 'им,ед', 'род,ед', 'вин,ед'}], ['месяц', {'вин,ед', 'им,ед'}]]
ледяной квас	[['ледяной', {'твор,ед', 'пр,ед', 'дат,ед', 'им,ед', 'род,ед', 'вин,ед'}], ['квас', {'вин,ед', 'им,ед'}]]
ледяная почва	[['ледяной', {'им,ед'}], ['почва', {'им,ед'}]]
ледяные каскады	[['ледяной', {'вин,мн', 'им,мн'}], ['каскад', {'вин,мн', 'им,мн'}]]
ледяной среде	[['ледяной', {'твор,ед', 'пр,ед', 'дат,ед', 'им,ед', 'род,ед', 'вин,ед'}], ['среда', {'дат,ед', 'пр,ед'}]]
ледяных отложений	[['ледяной', {'пр,мн', 'род,мн', 'вин,мн'}], ['отложение', {'род,мн'}]]
ледяной мгле	[['ледяной', {'твор,ед', 'пр,ед', 'дат,ед', 'им,ед', 'род,ед', 'вин,ед'}], ['мгла', {'дат,ед', 'пр,ед'}]]
ледяная долина	[['ледяной', {'им,ед'}], ['долина', {'им,ед'}]]
ледяной прослойки	[['ледяной', {'твор,ед', 'пр,ед', 'дат,ед', 'им,ед', 'род,ед', 'вин,ед'}], ['прослойка', {'вин,мн', 'род,ед', 'им,мн'}]]
ледяной ураган	[['ледяной', {'твор,ед', 'пр,ед', 'дат,ед', 'им,ед', 'род,ед', 'вин,ед'}], ['ураган', {'вин,ед', 'им,ед'}]]
ледяных аэродромов	[['ледяной', {'пр,мн', 'род,мн', 'вин,мн'}], ['аэродром', {'род,мн'}]]
ледяной бахромой	[['ледяной', {'твор,ед', 'пр,ед', 'дат,ед', 'им,ед', 'род,ед', 'вин,ед'}], ['бахрома', {'твор,ед'}]]
ледяной НАс	[['ледяной', {'твор,ед', 'пр,ед', 'дат,ед', 'им,ед', 'род,ед', 'вин,ед'}], ['мы', {'пр,мн', 'род,мн', 'вин,мн'}]]
ледяной коридор	[['ледяной', {'твор,ед', 'пр,ед', 'дат,ед', 'им,ед', 'род,ед', 'вин,ед'}], ['коридор', {'вин,ед', 'им,ед'}]]
ледяные хребты	[['ледяной', {'вин,мн', 'им,мн'}], ['хребет', {'вин,мн', 'им,мн'}]]
ледяной стенки	[['ледяной', {'твор,ед', 'пр,ед', 'дат,ед', 'им,ед', 'род,ед', 'вин,ед'}], ['стенка', {'вин,мн', 'род,ед', 'им,мн'}]]
ледяным прослойкам	[['ледяной', {'дат,мн', 'твор,ед'}], ['прослойка', {'дат,мн'}]]
ледяная влага	[['ледяной', {'им,ед'}], ['влага', {'им,ед'}]]
ледяных озер	[['ледяной', {'пр,мн', 'род,мн', 'вин,мн'}], ['озеро', {'род,мн'}]]
ледяные сооружения	[['ледяной', {'вин,мн', 'им,мн'}], ['сооружение', {'вин,мн', 'род,ед', 'им,мн'}]]
ледяную пустоту	[['ледяной', {'вин,ед'}], ['пустота', {'вин,ед'}]]
ледяная буря	[['ледяной', {'им,ед'}], ['буря', {'им,ед'}]]
ледяном основании	[['ледяной', {'пр,ед'}], ['основание', {'пр,ед'}]]
ледяной могилы	[['ледяной', {'твор,ед', 'пр,ед', 'дат,ед', 'им,ед', 'род,ед', 'вин,ед'}], ['могила', {'вин,мн', 'род,ед', 'им,мн'}]]
ледяное бесстрастие	[['ледяной', {'вин,ед', 'им,ед'}], ['бесстрастие', {'вин,ед', 'им,ед'}]]
ледяным ветрам	[['ледяной', {'дат,мн', 'твор,ед'}], ['ветер', {'дат,мн'}]]
ледяные купола	[['ледяной', {'вин,мн', 'им,мн'}], ['купол', {'вин,мн', 'род,ед', 'им,мн'}]]
ледяная рука	[['ледяной', {'им,ед'}], ['рука', {'им,ед'}]]
ледяными порывами	[['ледяной', {'твор,мн'}], ['порыв', {'твор,мн'}]]
ледяного свода	[['ледяной', {'род,ед', 'вин,ед'}], ['свод', {'род,ед'}]]
ледяная стынь	[['ледяной', {'им,ед'}], ['стыть', set()]]
ледяной обиде	[['ледяной', {'твор,ед', 'пр,ед', 'дат,ед', 'им,ед', 'род,ед', 'вин,ед'}], ['обида', {'дат,ед', 'пр,ед'}]]
ледяной чашке	[['ледяной', {'твор,ед', 'пр,ед', 'дат,ед', 'им,ед', 'род,ед', 'вин,ед'}], ['чашка', {'дат,ед', 'пр,ед'}]]
ледяной свод	[['ледяной', {'твор,ед', 'пр,ед', 'дат,ед', 'им,ед', 'род,ед', 'вин,ед'}], ['свод', {'вин,ед', 'им,ед'}]]
ледяная рыба	[['ледяной', {'им,ед'}], ['рыба', {'им,ед'}]]
ледяных узорах	[['ледяной', {'пр,мн', 'род,мн', 'вин,мн'}], ['узор', {'пр,мн'}]]
ледяного холма	[['ледяной', {'род,ед', 'вин,ед'}], ['холм', {'род,ед'}]]
ледяную крышу	[['ледяной', {'вин,ед'}], ['крыша', {'вин,ед'}]]
ледяными компрессами	[['ледяной', {'твор,мн'}], ['компресс', {'твор,мн'}]]
ледяному тону	[['ледяной', {'дат,ед'}], ['тон', {'дат,ед'}]]
ледяной блок	[['ледяной', {'твор,ед', 'пр,ед', 'дат,ед', 'им,ед', 'род,ед', 'вин,ед'}], ['блок', {'вин,ед', 'им,ед'}]]
ледяные конусы	[['ледяной', {'вин,мн', 'им,мн'}], ['конус', {'вин,мн', 'им,мн'}]]
ледяного калориметра	[['ледяной', {'род,ед', 'вин,ед'}], ['калориметр', {'род,ед'}]]
ледяного погреба	[['ледяной', {'род,ед', 'вин,ед'}], ['погреб', {'вин,мн', 'род,ед', 'им,мн'}]]
ледяного болота	[['ледяной', {'род,ед', 'вин,ед'}], ['болото', {'вин,мн', 'род,ед', 'им,мн'}]]
ледяном спокойствии	[['ледяной', {'пр,ед'}], ['спокойствие', {'пр,ед'}]]
ледяную атмосферу	[['ледяной', {'вин,ед'}], ['атмосфера', {'вин,ед'}]]
ледяной температуры	[['ледяной', {'твор,ед', 'пр,ед', 'дат,ед', 'им,ед', 'род,ед', 'вин,ед'}], ['температура', {'вин,мн', 'род,ед', 'им,мн'}]]
ледяной вечер	[['ледяной', {'твор,ед', 'пр,ед', 'дат,ед', 'им,ед', 'род,ед', 'вин,ед'}], ['вечер', {'вин,ед', 'им,ед'}]]
ледяная пустыня	[['ледяной', {'им,ед'}], ['пустыня', {'им,ед'}]]
