мокрую комнату	[['мокрый', {'вин,ед'}], ['комната', {'вин,ед'}]]
мокрым тряпьем	[['мокрый', {'твор,ед', 'дат,мн'}], ['тряпье', {'твор,ед'}]]
мокрые зубы	[['мокрый', {'вин,мн', 'им,мн'}], ['зуб', {'вин,мн', 'им,мн'}]]
мокрого платка	[['мокрый', {'вин,ед', 'род,ед'}], ['платок', {'род,ед'}]]
мокрый ватник	[['мокрый', {'вин,ед', 'им,ед'}], ['ватник', {'вин,ед', 'им,ед'}]]
мокрые окна	[['мокрый', {'вин,мн', 'им,мн'}], ['окно', {'вин,мн', 'род,ед', 'им,мн'}]]
мокрая душонка	[['мокрый', {'им,ед'}], ['душонка', {'им,ед'}]]
мокрый булыжник	[['мокрый', {'вин,ед', 'им,ед'}], ['булыжник', {'вин,ед', 'им,ед'}]]
мокрого пола	[['мокрый', {'вин,ед', 'род,ед'}], ['пол', {'вин,ед', 'род,ед', 'ед,кр,жен', 'им,ед'}]]
мокрый песокъ	[['мокрый', {'вин,ед', 'им,ед'}], ['песок', {'вин,ед', 'им,ед'}]]
мокрой шлифовки	[['мокрый', {'дат,ед', 'твор,ед', 'род,ед', 'пр,ед'}], ['шлифовка', {'вин,мн', 'род,ед', 'им,мн'}]]
мокрых губ	[['мокрый', {'род,мн', 'вин,мн', 'пр,мн'}], ['губа', {'род,мн'}]]
мокрой шахте	[['мокрый', {'дат,ед', 'твор,ед', 'род,ед', 'пр,ед'}], ['шахта', {'дат,ед', 'пр,ед'}]]
мокрой руки	[['мокрый', {'дат,ед', 'твор,ед', 'род,ед', 'пр,ед'}], ['рука', {'вин,мн', 'род,ед', 'им,мн'}]]
мокрая осень	[['мокрый', {'им,ед'}], ['осень', {'вин,ед', 'им,ед'}]]
мокрая жижа	[['мокрый', {'им,ед'}], ['жижа', {'им,ед'}]]
мокрый столб	[['мокрый', {'вин,ед', 'им,ед'}], ['столб', {'вин,ед', 'им,ед'}]]
мокрыми поцелуями	[['мокрый', {'твор,мн'}], ['поцелуй', {'твор,мн'}]]
мокрой палубой	[['мокрый', {'дат,ед', 'твор,ед', 'род,ед', 'пр,ед'}], ['палуба', {'твор,ед'}]]
мокрой стали	[['мокрый', {'дат,ед', 'твор,ед', 'род,ед', 'пр,ед'}], ['становиться=V,нп=прош,мн,изъяв,сов', {'род,ед', 'пр,ед', 'вин,мн', 'им,мн', 'прош,мн,изъяв,сов', 'дат,ед'}]]
мокром пальто	[['мокрый', {'пр,ед'}], ['пальто', {'род,ед', 'пр,ед', 'род,мн', 'твор,ед', 'вин,мн', 'им,мн', 'дат,мн', 'им,ед', 'твор,мн', 'вин,ед', 'пр,мн', 'дат,ед'}]]
мокрое время	[['мокрый', {'вин,ед', 'им,ед'}], ['время', {'вин,ед', 'им,ед'}]]
мокрым холодом	[['мокрый', {'твор,ед', 'дат,мн'}], ['холод', {'твор,ед'}]]
мокрой шваброй	[['мокрый', {'дат,ед', 'твор,ед', 'род,ед', 'пр,ед'}], ['швабра', {'твор,ед'}]]
мокрые листочки	[['мокрый', {'вин,мн', 'им,мн'}], ['листочек', {'вин,мн', 'им,мн'}]]
мокрой одежды	[['мокрый', {'дат,ед', 'твор,ед', 'род,ед', 'пр,ед'}], ['одежда', {'вин,мн', 'род,ед', 'им,мн'}]]
мокром снеге	[['мокрый', {'пр,ед'}], ['снег', {'пр,ед'}]]
мокрое шлифование	[['мокрый', {'вин,ед', 'им,ед'}], ['шлифование', {'вин,ед', 'им,ед'}]]
мокром ватнике	[['мокрый', {'пр,ед'}], ['ватник', {'пр,ед'}]]
мокрая птица	[['мокрый', {'им,ед'}], ['птица', {'им,ед'}]]
мокрой ямы	[['мокрый', {'дат,ед', 'твор,ед', 'род,ед', 'пр,ед'}], ['яма', {'вин,мн', 'род,ед', 'им,мн'}]]
мокрыми руками	[['мокрый', {'твор,мн'}], ['рука', {'твор,мн'}]]
мокрые воробьи	[['мокрый', {'вин,мн', 'им,мн'}], ['воробей', {'им,мн'}]]
мокрой скамьи	[['мокрый', {'дат,ед', 'твор,ед', 'род,ед', 'пр,ед'}], ['скамья', {'вин,мн', 'род,ед', 'им,мн'}]]
мокрых крышах	[['мокрый', {'род,мн', 'вин,мн', 'пр,мн'}], ['крыша', {'пр,мн'}]]
мокрого просеивания	[['мокрый', {'вин,ед', 'род,ед'}], ['просеивание', {'вин,мн', 'род,ед', 'им,мн'}]]
мокрой зелени	[['мокрый', {'дат,ед', 'твор,ед', 'род,ед', 'пр,ед'}], ['зелень', {'род,ед', 'пр,ед', 'ед,пов,2-л', 'вин,мн', 'им,мн', 'дат,ед'}]]
мокром состояниях	[['мокрый', {'пр,ед'}], ['состояние', {'пр,мн'}]]
мокрое сукно	[['мокрый', {'вин,ед', 'им,ед'}], ['сукно', {'вин,ед', 'им,ед'}]]
мокрым стеклом	[['мокрый', {'твор,ед', 'дат,мн'}], ['стекло', {'твор,ед'}]]
мокрую темноту	[['мокрый', {'вин,ед'}], ['темнота', {'вин,ед'}]]
мокрой тряпицей	[['мокрый', {'дат,ед', 'твор,ед', 'род,ед', 'пр,ед'}], ['тряпица', {'твор,ед'}]]
мокрым мосткам	[['мокрый', {'твор,ед', 'дат,мн'}], ['мосток', {'дат,мн'}]]
мокрые поленья	[['мокрый', {'вин,мн', 'им,мн'}], ['полено', {'вин,мн', 'им,мн'}]]
мокрый плащ	[['мокрый', {'вин,ед', 'им,ед'}], ['плащ', {'вин,ед', 'им,ед'}]]
мокрому лугу	[['мокрый', {'дат,ед'}], ['луг', {'вин,ед', 'местн,ед', 'дат,ед'}]]
мокрый платокъ	[['мокрый', {'вин,ед', 'им,ед'}], ['платок', {'вин,ед', 'им,ед'}]]
мокрой рубахе	[['мокрый', {'дат,ед', 'твор,ед', 'род,ед', 'пр,ед'}], ['рубаха', {'дат,ед', 'пр,ед'}]]
мокрое прикосновение	[['мокрый', {'вин,ед', 'им,ед'}], ['прикосновение', {'вин,ед', 'им,ед'}]]
мокрой каше	[['мокрый', {'дат,ед', 'твор,ед', 'род,ед', 'пр,ед'}], ['каша', {'дат,ед', 'пр,ед'}]]
мокрый термометр	[['мокрый', {'вин,ед', 'им,ед'}], ['термометр', {'вин,ед', 'им,ед'}]]
мокрую мордочку	[['мокрый', {'вин,ед'}], ['мордочка', {'вин,ед'}]]
мокрые глазки	[['мокрый', {'вин,мн', 'им,мн'}], ['глазок', {'вин,мн', 'им,мн'}]]
мокрая спина	[['мокрый', {'им,ед'}], ['спина', {'род,ед', 'им,ед'}]]
мокрых пятен	[['мокрый', {'род,мн', 'вин,мн', 'пр,мн'}], ['пятно', {'род,мн'}]]
мокрым губам	[['мокрый', {'твор,ед', 'дат,мн'}], ['губа', {'дат,мн'}]]
мокрые мостовые	[['мокрый', {'вин,мн', 'им,мн'}], ['мостовая', {'им,мн,полн', 'вин,мн,полн,неод', 'вин,мн', 'им,мн', 'вин,мн,неод'}]]
мокрых пылеуловителей	[['мокрый', {'род,мн', 'вин,мн', 'пр,мн'}], ['пылеуловитель', {'род,мн'}]]
мокрых обработок	[['мокрый', {'род,мн', 'вин,мн', 'пр,мн'}], ['обработка', {'род,мн'}]]
мокрых людей	[['мокрый', {'род,мн', 'вин,мн', 'пр,мн'}], ['человек', {'род,мн', 'вин,мн'}]]
мокрых пятна	[['мокрый', {'род,мн', 'вин,мн', 'пр,мн'}], ['пятно', {'вин,мн', 'род,ед', 'им,мн'}]]
мокрым брюхом	[['мокрый', {'твор,ед', 'дат,мн'}], ['брюхо', {'твор,ед'}]]
мокрых плитах	[['мокрый', {'род,мн', 'вин,мн', 'пр,мн'}], ['плита', {'пр,мн'}]]
мокрые пеленки	[['мокрый', {'вин,мн', 'им,мн'}], ['пеленка', {'вин,мн', 'род,ед', 'им,мн'}]]
мокрых штанах	[['мокрый', {'род,мн', 'вин,мн', 'пр,мн'}], ['штаны', {'пр,мн'}]]
мокрых спицах	[['мокрый', {'род,мн', 'вин,мн', 'пр,мн'}], ['спица', {'пр,мн'}]]
мокрой смородиной	[['мокрый', {'дат,ед', 'твор,ед', 'род,ед', 'пр,ед'}], ['смородина', {'дат,ед', 'твор,ед', 'род,ед', 'пр,ед'}]]
мокрые лбы	[['мокрый', {'вин,мн', 'им,мн'}], ['лоб', {'вин,мн', 'им,мн'}]]
мокрый сапог	[['мокрый', {'вин,ед', 'им,ед'}], ['сапог', {'вин,ед', 'род,мн', 'им,ед'}]]
мокрый кашель	[['мокрый', {'вин,ед', 'им,ед'}], ['кашель', {'вин,ед', 'им,ед'}]]
мокрую подушку	[['мокрый', {'вин,ед'}], ['подушка', {'вин,ед'}]]
мокрых галок	[['мокрый', {'род,мн', 'вин,мн', 'пр,мн'}], ['галка', {'род,мн', 'вин,мн'}]]
мокрая мгла	[['мокрый', {'им,ед'}], ['мгла', {'им,ед'}]]
мокрый камень	[['мокрый', {'вин,ед', 'им,ед'}], ['камень', {'вин,ед', 'им,ед'}]]
мокрую зелень	[['мокрый', {'вин,ед'}], ['зелень', {'вин,ед', 'им,ед'}]]
мокрой поверхности	[['мокрый', {'дат,ед', 'твор,ед', 'род,ед', 'пр,ед'}], ['поверхность', {'дат,ед', 'вин,мн', 'род,ед', 'им,мн', 'пр,ед'}]]
мокрых полях	[['мокрый', {'род,мн', 'вин,мн', 'пр,мн'}], ['поле', {'пр,мн'}]]
мокрый пар	[['мокрый', {'вин,ед', 'им,ед'}], ['пар', {'вин,ед', 'род,мн', 'им,ед'}]]
мокрыми носами	[['мокрый', {'твор,мн'}], ['нос', {'твор,мн'}]]
мокрым ветром	[['мокрый', {'твор,ед', 'дат,мн'}], ['ветер', {'твор,ед'}]]
мокрые листья	[['мокрый', {'вин,мн', 'им,мн'}], ['лист', {'вин,мн', 'им,мн'}]]
мокром носу	[['мокрый', {'пр,ед'}], ['нос', {'парт,ед', 'местн,ед', 'дат,ед'}]]
мокрое место	[['мокрый', {'вин,ед', 'им,ед'}], ['место', {'вин,ед', 'им,ед'}]]
мокрое весло	[['мокрый', {'вин,ед', 'им,ед'}], ['весло', {'вин,ед', 'им,ед'}]]
мокрый дождь	[['мокрый', {'вин,ед', 'им,ед'}], ['дождь', {'вин,ед', 'им,ед'}]]
мокрыми щетками	[['мокрый', {'твор,мн'}], ['щетка', {'твор,мн'}]]
мокрая кожа	[['мокрый', {'им,ед'}], ['кожа', {'им,ед'}]]
мокрых листьях	[['мокрый', {'род,мн', 'вин,мн', 'пр,мн'}], ['лист', {'пр,мн'}]]
мокрых способов	[['мокрый', {'род,мн', 'вин,мн', 'пр,мн'}], ['способ', {'род,мн'}]]
мокрых шинелях	[['мокрый', {'род,мн', 'вин,мн', 'пр,мн'}], ['шинель', {'пр,мн'}]]
мокрой весны	[['мокрый', {'дат,ед', 'твор,ед', 'род,ед', 'пр,ед'}], ['весна', {'вин,мн', 'род,ед', 'им,мн'}]]
мокрые мешки	[['мокрый', {'вин,мн', 'им,мн'}], ['мешок', {'вин,мн', 'им,мн'}]]
мокрый комбинезон	[['мокрый', {'вин,ед', 'им,ед'}], ['комбинезон', {'вин,ед', 'им,ед'}]]
мокрое платье	[['мокрый', {'вин,ед', 'им,ед'}], ['платье', {'вин,ед', 'им,ед', 'пр,ед'}]]
мокрому месту	[['мокрый', {'дат,ед'}], ['место', {'дат,ед'}]]
мокрую землю	[['мокрый', {'вин,ед'}], ['земля', {'вин,ед'}]]
мокрым скверам	[['мокрый', {'твор,ед', 'дат,мн'}], ['сквер', {'дат,мн'}]]
мокрым столом	[['мокрый', {'твор,ед', 'дат,мн'}], ['стол', {'твор,ед'}]]
мокрой тьме	[['мокрый', {'дат,ед', 'твор,ед', 'род,ед', 'пр,ед'}], ['тьма', {'дат,ед', 'пр,ед'}]]
мокрыми крышами	[['мокрый', {'твор,мн'}], ['крыша', {'твор,мн'}]]
мокрого носа	[['мокрый', {'вин,ед', 'род,ед'}], ['нос', {'род,ед'}]]
мокраго белья	[['мокрый', {'устар,вин', 'устар,род'}], ['белье', {'род,ед'}]]
мокрым плечом	[['мокрый', {'твор,ед', 'дат,мн'}], ['плечо', {'твор,ед'}]]
мокрой провизии	[['мокрый', {'дат,ед', 'твор,ед', 'род,ед', 'пр,ед'}], ['провизия', {'дат,ед', 'вин,мн', 'род,ед', 'им,мн', 'пр,ед'}]]
мокрых помещений	[['мокрый', {'род,мн', 'вин,мн', 'пр,мн'}], ['помещение', {'род,мн'}]]
мокрой грязью	[['мокрый', {'дат,ед', 'твор,ед', 'род,ед', 'пр,ед'}], ['грязь', {'твор,ед'}]]
мокрой мостовой	[['мокрый', {'дат,ед', 'твор,ед', 'род,ед', 'пр,ед'}], ['мостовая', {'род,ед,жен', 'род,ед', 'пр,ед', 'вин,ед,полн,муж,неод', 'твор,ед', 'пр,ед,жен', 'им,ед', 'дат,ед,жен', 'им,ед,полн,муж', 'род,ед,полн,жен', 'твор,ед,полн,жен', 'пр,ед,полн,жен', 'дат,ед,полн,жен', 'твор,ед,жен', 'дат,ед'}]]
мокрой гимнастерки	[['мокрый', {'дат,ед', 'твор,ед', 'род,ед', 'пр,ед'}], ['гимнастерка', {'вин,мн', 'род,ед', 'им,мн'}]]
мокрыми гумнами	[['мокрый', {'твор,мн'}], ['гумно', {'твор,мн'}]]
мокрых скрубберов	[['мокрый', {'род,мн', 'вин,мн', 'пр,мн'}], ['скруббер', {'род,мн'}]]
мокрым веником	[['мокрый', {'твор,ед', 'дат,мн'}], ['веник', {'твор,ед'}]]
мокрой осенью	[['мокрый', {'дат,ед', 'твор,ед', 'род,ед', 'пр,ед'}], ['осень', {'', 'твор,ед'}]]
мокрой бородой	[['мокрый', {'дат,ед', 'твор,ед', 'род,ед', 'пр,ед'}], ['борода', {'твор,ед'}]]
мокрой шлифовке	[['мокрый', {'дат,ед', 'твор,ед', 'род,ед', 'пр,ед'}], ['шлифовка', {'дат,ед', 'пр,ед'}]]
мокрый живот	[['мокрый', {'вин,ед', 'им,ед'}], ['живот', {'вин,ед', 'им,ед'}]]
мокрая уборка	[['мокрый', {'им,ед'}], ['уборка', {'им,ед'}]]
мокрый перрон	[['мокрый', {'вин,ед', 'им,ед'}], ['перрон', {'вин,ед', 'им,ед'}]]
мокрую салфетку	[['мокрый', {'вин,ед'}], ['салфетка', {'вин,ед'}]]
мокрый труп	[['мокрый', {'вин,ед', 'им,ед'}], ['труп', {'вин,ед', 'им,ед'}]]
мокрых камышей	[['мокрый', {'род,мн', 'вин,мн', 'пр,мн'}], ['камыш', {'род,мн'}]]
мокрой ладошкой	[['мокрый', {'дат,ед', 'твор,ед', 'род,ед', 'пр,ед'}], ['ладошка', {'твор,ед'}]]
мокрая гимнастерка	[['мокрый', {'им,ед'}], ['гимнастерка', {'им,ед'}]]
мокрых куртин	[['мокрый', {'род,мн', 'вин,мн', 'пр,мн'}], ['куртина', {'род,мн', 'им,ед'}]]
мокром бетоне	[['мокрый', {'пр,ед'}], ['бетон', {'пр,ед'}]]
мокрая кора	[['мокрый', {'им,ед'}], ['кора', {'им,ед'}]]
мокрая бумага	[['мокрый', {'им,ед'}], ['бумага', {'им,ед'}]]
мокрых кровель	[['мокрый', {'род,мн', 'вин,мн', 'пр,мн'}], ['кровля', {'род,мн'}]]
мокрую сдачу	[['мокрый', {'вин,ед'}], ['сдача', {'вин,ед'}]]
мокрую мышь	[['мокрый', {'вин,ед'}], ['мышь', {'вин,ед', 'им,ед'}]]
мокрые сапоги	[['мокрый', {'вин,мн', 'им,мн'}], ['сапог', {'вин,мн', 'им,мн'}]]
мокром способе	[['мокрый', {'пр,ед'}], ['способ', {'пр,ед'}]]
мокрые пески	[['мокрый', {'вин,мн', 'им,мн'}], ['песок', {'вин,мн', 'им,мн'}]]
мокрую осень	[['мокрый', {'вин,ед'}], ['осень', {'вин,ед', 'им,ед'}]]
мокрая ветка	[['мокрый', {'им,ед'}], ['ветка', {'им,ед'}]]
мокрых гнилей	[['мокрый', {'род,мн', 'вин,мн', 'пр,мн'}], ['гниль', {'род,мн', 'срав'}]]
мокрый локон	[['мокрый', {'вин,ед', 'им,ед'}], ['локон', {'вин,ед', 'им,ед'}]]
мокрой площади	[['мокрый', {'дат,ед', 'твор,ед', 'род,ед', 'пр,ед'}], ['площадь', {'дат,ед', 'вин,мн', 'род,ед', 'им,мн', 'пр,ед'}]]
мокрых ржах	[['мокрый', {'род,мн', 'вин,мн', 'пр,мн'}], ['рожь', {'пр,мн'}]]
мокрых подштанниках	[['мокрый', {'род,мн', 'вин,мн', 'пр,мн'}], ['подштанники', {'пр,мн'}]]
мокрой вате	[['мокрый', {'дат,ед', 'твор,ед', 'род,ед', 'пр,ед'}], ['вата', {'дат,ед', 'пр,ед'}]]
мокрое полено	[['мокрый', {'вин,ед', 'им,ед'}], ['полено', {'вин,ед', 'им,ед'}]]
мокрым щекам	[['мокрый', {'твор,ед', 'дат,мн'}], ['щека', {'дат,мн'}]]
мокрой его	[['мокрый', {'дат,ед', 'твор,ед', 'род,ед', 'пр,ед'}], ['он=SPRO,ед,3-л,муж=вин', {'род,мн,сред', 'дат,мн', 'вин,ед,жен', 'дат,ед,жен', 'пр,мн,муж', 'твор,ед,сред', 'дат,мн,муж', 'род,ед,жен', 'им,мн,сред', 'твор,ед,муж', 'им,ед,сред', 'им,мн', 'род,ед,сред', 'твор,мн,сред', 'дат,ед,сред', 'вин,мн,муж', 'им,ед,муж', 'им,ед,жен', 'твор,ед,жен', 'пр,мн,сред', 'род,мн', 'вин,мн,од', 'пр,ед,жен', 'дат,ед,муж', 'вин,ед,сред', 'пр,ед,сред', 'пр,мн', 'вин,ед,муж,неод', 'вин,мн,сред', 'род,ед', 'род,ед,муж', 'вин,мн,неод', 'вин,ед,муж,од', 'твор,мн', 'дат,мн,сред', 'вин,ед,муж', 'пр,ед,муж', 'вин,ед'}]]
мокрая сирень	[['мокрый', {'им,ед'}], ['сирень', {'вин,ед', 'им,ед'}]]
мокрых листьев	[['мокрый', {'род,мн', 'вин,мн', 'пр,мн'}], ['лист', {'род,мн', 'им,ед'}]]
мокрому столу	[['мокрый', {'дат,ед'}], ['стол', {'дат,ед'}]]
мокрый веник	[['мокрый', {'вин,ед', 'им,ед'}], ['веник', {'вин,ед', 'им,ед'}]]
мокрым кустарником	[['мокрый', {'твор,ед', 'дат,мн'}], ['кустарник', {'твор,ед'}]]
мокрой накидке	[['мокрый', {'дат,ед', 'твор,ед', 'род,ед', 'пр,ед'}], ['накидка', {'дат,ед', 'пр,ед'}]]
мокрую скатерть	[['мокрый', {'вин,ед'}], ['скатерть', {'вин,ед', 'им,ед'}]]
мокрые канаты	[['мокрый', {'вин,мн', 'им,мн'}], ['канат', {'вин,мн', 'им,мн'}]]
мокрое окисление	[['мокрый', {'вин,ед', 'им,ед'}], ['окисление', {'вин,ед', 'им,ед'}]]
мокрый картуз	[['мокрый', {'вин,ед', 'им,ед'}], ['картуз', {'вин,ед', 'им,ед'}]]
мокрой коже	[['мокрый', {'дат,ед', 'твор,ед', 'род,ед', 'пр,ед'}], ['кожа', {'дат,ед', 'пр,ед'}]]
мокрую куртку	[['мокрый', {'вин,ед'}], ['куртка', {'вин,ед'}]]
мокрому лету	[['мокрый', {'дат,ед'}], ['лето', {'парт,ед', 'местн,ед', 'дат,ед'}]]
мокрого электрофильтра	[['мокрый', {'вин,ед', 'род,ед'}], ['электрофильтр', {'род,ед'}]]
мокрый тротуар	[['мокрый', {'вин,ед', 'им,ед'}], ['тротуар', {'вин,ед', 'им,ед'}]]
мокром цехе	[['мокрый', {'пр,ед'}], ['цех', {'пр,ед'}]]
мокрую кучу	[['мокрый', {'вин,ед'}], ['куча', {'вин,ед', 'непрош,ед,изъяв,1-л'}]]
мокрой яме	[['мокрый', {'дат,ед', 'твор,ед', 'род,ед', 'пр,ед'}], ['яма', {'дат,ед', 'пр,ед'}]]
мокрая собака	[['мокрый', {'им,ед'}], ['собака', {'им,ед'}]]
мокрых кустах	[['мокрый', {'род,мн', 'вин,мн', 'пр,мн'}], ['куст', {'пр,мн'}]]
мокрый грунт	[['мокрый', {'вин,ед', 'им,ед'}], ['грунт', {'вин,ед', 'им,ед'}]]
мокрым размолом	[['мокрый', {'твор,ед', 'дат,мн'}], ['размол', {'твор,ед'}]]
мокрое рванье	[['мокрый', {'вин,ед', 'им,ед'}], ['рванье', {'вин,ед', 'им,ед', 'пр,ед'}]]
мокрое обмундирование	[['мокрый', {'вин,ед', 'им,ед'}], ['обмундирование', {'вин,ед', 'им,ед'}]]
мокрый платочек	[['мокрый', {'вин,ед', 'им,ед'}], ['платочек', {'вин,ед', 'им,ед'}]]
мокрая почва	[['мокрый', {'им,ед'}], ['почва', {'им,ед'}]]
мокрой губой	[['мокрый', {'дат,ед', 'твор,ед', 'род,ед', 'пр,ед'}], ['губа', {'твор,ед'}]]
мокрая полоска	[['мокрый', {'им,ед'}], ['полоска', {'им,ед'}]]
мокрую кошку	[['мокрый', {'вин,ед'}], ['кошка', {'вин,ед'}]]
мокрые рубахи	[['мокрый', {'вин,мн', 'им,мн'}], ['рубаха', {'вин,мн', 'род,ед', 'им,мн'}]]
мокрый скруббер	[['мокрый', {'вин,ед', 'им,ед'}], ['скруббер', {'вин,ед', 'им,ед'}]]
мокрый затылок	[['мокрый', {'вин,ед', 'им,ед'}], ['затылок', {'вин,ед', 'им,ед'}]]
мокрую перекладину	[['мокрый', {'вин,ед'}], ['перекладина', {'вин,ед'}]]
мокрым пятном	[['мокрый', {'твор,ед', 'дат,мн'}], ['пятно', {'твор,ед'}]]
мокрую майку	[['мокрый', {'вин,ед'}], ['майка', {'вин,ед', 'дат,ед'}]]
мокрая мостовая	[['мокрый', {'им,ед'}], ['мостовая', {'им,ед,жен', 'им,ед', 'им,ед,полн,жен'}]]
мокрым кулаком	[['мокрый', {'твор,ед', 'дат,мн'}], ['кулак', {'твор,ед'}]]
мокрой мордочкой	[['мокрый', {'дат,ед', 'твор,ед', 'род,ед', 'пр,ед'}], ['мордочка', {'твор,ед'}]]
мокрыми способами	[['мокрый', {'твор,мн'}], ['способ', {'твор,мн'}]]
мокрому навозу	[['мокрый', {'дат,ед'}], ['навоз', {'парт,ед', 'дат,ед'}]]
мокрый халат	[['мокрый', {'вин,ед', 'им,ед'}], ['халат', {'вин,ед', 'им,ед'}]]
мокрых почв	[['мокрый', {'род,мн', 'вин,мн', 'пр,мн'}], ['почва', {'род,мн'}]]
мокрой ветки	[['мокрый', {'дат,ед', 'твор,ед', 'род,ед', 'пр,ед'}], ['ветка', {'вин,мн', 'род,ед', 'им,мн'}]]
мокрым усам	[['мокрый', {'твор,ед', 'дат,мн'}], ['ус', {'род,мн', 'вин,мн', 'дат,мн'}]]
мокрый ком	[['мокрый', {'вин,ед', 'им,ед'}], ['кто=SPRO,ед,муж,од=пр', {'вин,ед', 'род,мн', 'им,ед', 'пр,ед'}]]
мокрых спин	[['мокрый', {'род,мн', 'вин,мн', 'пр,мн'}], ['спина', {'род,мн', 'вин,ед', 'им,ед'}]]
мокрым платком	[['мокрый', {'твор,ед', 'дат,мн'}], ['платок', {'твор,ед'}]]
мокрыми цветами	[['мокрый', {'твор,мн'}], ['цветок', {'твор,мн'}]]
мокрой гальке	[['мокрый', {'дат,ед', 'твор,ед', 'род,ед', 'пр,ед'}], ['галька', {'дат,ед', 'пр,ед'}]]
мокрое шоссе	[['мокрый', {'вин,ед', 'им,ед'}], ['шоссе', {'род,ед', 'пр,ед', 'род,мн', 'твор,ед', 'вин,мн', 'им,мн', 'дат,мн', 'им,ед', 'твор,мн', 'вин,ед', 'пр,мн', 'дат,ед'}]]
мокрых сумерках	[['мокрый', {'род,мн', 'вин,мн', 'пр,мн'}], ['сумерки', {'пр,мн'}]]
мокрой регенерации	[['мокрый', {'дат,ед', 'твор,ед', 'род,ед', 'пр,ед'}], ['регенерация', {'дат,ед', 'вин,мн', 'род,ед', 'им,мн', 'пр,ед'}]]
мокрые пальто	[['мокрый', {'вин,мн', 'им,мн'}], ['пальто', {'род,ед', 'пр,ед', 'род,мн', 'твор,ед', 'вин,мн', 'им,мн', 'дат,мн', 'им,ед', 'твор,мн', 'вин,ед', 'пр,мн', 'дат,ед'}]]
мокрому настилу	[['мокрый', {'дат,ед'}], ['настил', {'дат,ед'}]]
мокрый ил	[['мокрый', {'вин,ед', 'им,ед'}], ['ил', {'вин,ед', 'им,ед'}]]
мокрый солончак	[['мокрый', {'вин,ед', 'им,ед'}], ['солончак', {'вин,ед', 'им,ед'}]]
мокрым лугам	[['мокрый', {'твор,ед', 'дат,мн'}], ['луг', {'дат,мн'}]]
мокрая кашица	[['мокрый', {'им,ед'}], ['кашица', {'им,ед'}]]
мокрой травой	[['мокрый', {'дат,ед', 'твор,ед', 'род,ед', 'пр,ед'}], ['трава', {'твор,ед'}]]
мокрого улавливания	[['мокрый', {'вин,ед', 'род,ед'}], ['улавливание', {'вин,мн', 'род,ед', 'им,мн'}]]
мокрые слезы	[['мокрый', {'вин,мн', 'им,мн'}], ['слеза', {'вин,мн', 'род,ед', 'им,мн'}]]
мокрыми брезентами	[['мокрый', {'твор,мн'}], ['брезент', {'твор,мн'}]]
мокрыми окнами	[['мокрый', {'твор,мн'}], ['окно', {'твор,мн'}]]
мокрое белье	[['мокрый', {'вин,ед', 'им,ед'}], ['белье', {'вин,ед', 'им,ед', 'пр,ед'}]]
мокрой листвой	[['мокрый', {'дат,ед', 'твор,ед', 'род,ед', 'пр,ед'}], ['листва', {'твор,ед'}]]
мокрой стене	[['мокрый', {'дат,ед', 'твор,ед', 'род,ед', 'пр,ед'}], ['стена', {'дат,ед', 'пр,ед'}]]
мокрые болота	[['мокрый', {'вин,мн', 'им,мн'}], ['болото', {'вин,ед', 'вин,мн', 'род,ед', 'им,мн'}]]
мокрого тряпья	[['мокрый', {'вин,ед', 'род,ед'}], ['тряпье', {'род,ед'}]]
мокрого слоя	[['мокрый', {'вин,ед', 'род,ед'}], ['слой', {'непрош,деепр', 'род,ед'}]]
мокрый ствол	[['мокрый', {'вин,ед', 'им,ед'}], ['ствол', {'вин,ед', 'им,ед'}]]
мокрая борода	[['мокрый', {'им,ед'}], ['борода', {'им,ед'}]]
мокрые опорки	[['мокрый', {'вин,мн', 'им,мн'}], ['опорок', {'вин,мн', 'им,мн'}]]
мокрой очисткой	[['мокрый', {'дат,ед', 'твор,ед', 'род,ед', 'пр,ед'}], ['очистка', {'твор,ед'}]]
мокрыми сосульками	[['мокрый', {'твор,мн'}], ['сосулька', {'твор,мн'}]]
мокрую кашу	[['мокрый', {'вин,ед'}], ['каша', {'вин,ед'}]]
мокрого шлифования	[['мокрый', {'вин,ед', 'род,ед'}], ['шлифование', {'вин,мн', 'род,ед', 'им,мн'}]]
мокрую скамью	[['мокрый', {'вин,ед'}], ['скамья', {'вин,ед'}]]
мокрые плавки	[['мокрый', {'вин,мн', 'им,мн'}], ['плавки', {'мн,кр', 'вин,мн', 'им,мн', 'род,ед'}]]
мокрый туман	[['мокрый', {'вин,ед', 'им,ед'}], ['туман', {'вин,ед', 'им,ед'}]]
мокрой почве	[['мокрый', {'дат,ед', 'твор,ед', 'род,ед', 'пр,ед'}], ['почва', {'дат,ед', 'пр,ед'}]]
мокрой хвои	[['мокрый', {'дат,ед', 'твор,ед', 'род,ед', 'пр,ед'}], ['хвоя', {'вин,мн', 'род,ед', 'им,мн', 'ед,пов,2-л'}]]
мокрую штанину	[['мокрый', {'вин,ед'}], ['штанина', {'вин,ед'}]]
мокрых работах	[['мокрый', {'род,мн', 'вин,мн', 'пр,мн'}], ['работа', {'пр,мн'}]]
мокрой погоде	[['мокрый', {'дат,ед', 'твор,ед', 'род,ед', 'пр,ед'}], ['погода', {'дат,ед', 'пр,ед'}]]
мокрому днищу	[['мокрый', {'дат,ед'}], ['днище', {'дат,ед'}]]
мокрое тельце	[['мокрый', {'вин,ед', 'им,ед'}], ['тельце', {'вин,ед', 'им,ед', 'пр,ед'}]]
мокрым кустам	[['мокрый', {'твор,ед', 'дат,мн'}], ['куст', {'дат,мн'}]]
мокрый воздух	[['мокрый', {'вин,ед', 'им,ед'}], ['воздух', {'вин,ед', 'им,ед'}]]
мокром мешке	[['мокрый', {'пр,ед'}], ['мешок', {'пр,ед'}]]
мокрому двору	[['мокрый', {'дат,ед'}], ['двор', {'дат,ед'}]]
мокрую метель	[['мокрый', {'вин,ед'}], ['метель', {'вин,ед', 'им,ед'}]]
мокрой шинели	[['мокрый', {'дат,ед', 'твор,ед', 'род,ед', 'пр,ед'}], ['шинель', {'дат,ед', 'вин,мн', 'род,ед', 'им,мн', 'пр,ед'}]]
мокрой глины	[['мокрый', {'дат,ед', 'твор,ед', 'род,ед', 'пр,ед'}], ['глина', {'вин,мн', 'род,ед', 'им,мн'}]]
мокрого термометра	[['мокрый', {'вин,ед', 'род,ед'}], ['термометр', {'род,ед'}]]
мокрая зима	[['мокрый', {'им,ед'}], ['зима', {'род,ед', 'им,ед'}]]
мокрых окопах	[['мокрый', {'род,мн', 'вин,мн', 'пр,мн'}], ['окоп', {'пр,мн'}]]
мокрой шерсти	[['мокрый', {'дат,ед', 'твор,ед', 'род,ед', 'пр,ед'}], ['шерсть', {'род,ед', 'пр,ед', 'ед,пов,2-л', 'вин,мн', 'им,мн', 'дат,ед'}]]
мокрому лицу	[['мокрый', {'дат,ед'}], ['лицо', {'дат,ед'}]]
мокрое обогащение	[['мокрый', {'вин,ед', 'им,ед'}], ['обогащение', {'вин,ед', 'им,ед'}]]
мокром виде	[['мокрый', {'пр,ед'}], ['вид', {'пр,ед'}]]
мокрые ее	[['мокрый', {'вин,мн', 'им,мн'}], ['она=SPRO,ед,3-л,жен=вин', {'род,мн,сред', 'дат,мн', 'вин,ед,жен', 'дат,ед,жен', 'пр,мн,муж', 'твор,ед,сред', 'дат,мн,муж', 'род,ед,жен', 'им,мн,сред', 'твор,ед,муж', 'им,ед,сред', 'им,мн', 'род,ед,сред', 'твор,мн,сред', 'дат,ед,сред', 'вин,мн,муж', 'им,ед,муж', 'им,ед,жен', 'твор,ед,жен', 'пр,мн,сред', 'род,мн', 'вин,мн,од', 'пр,ед,жен', 'дат,ед,муж', 'вин,ед,сред', 'пр,ед,сред', 'пр,мн', 'вин,ед,муж,неод', 'вин,мн,сред', 'род,ед', 'род,ед,муж', 'вин,мн,неод', 'вин,ед,муж,од', 'твор,мн', 'дат,мн,сред', 'вин,ед,муж', 'пр,ед,муж', 'вин,ед'}]]
мокрый помол	[['мокрый', {'вин,ед', 'им,ед'}], ['помол', {'вин,ед', 'им,ед'}]]
мокрые доспехи	[['мокрый', {'вин,мн', 'им,мн'}], ['доспехи', {'вин,мн', 'им,мн'}]]
мокрых сапог	[['мокрый', {'род,мн', 'вин,мн', 'пр,мн'}], ['сапог', {'вин,ед', 'род,мн', 'им,ед'}]]
мокрые сливы	[['мокрый', {'вин,мн', 'им,мн'}], ['слива', {'вин,мн', 'род,ед', 'им,мн'}]]
мокрого помола	[['мокрый', {'вин,ед', 'род,ед'}], ['помол', {'род,ед'}]]
мокрый Иван	[['мокрый', {'вин,ед', 'им,ед'}], ['иван', {'им,ед'}]]
мокрый лед	[['мокрый', {'вин,ед', 'им,ед'}], ['лед', {'вин,ед', 'род,мн', 'вин,мн', 'им,ед'}]]
мокрого мешка	[['мокрый', {'вин,ед', 'род,ед'}], ['мешок', {'вин,ед', 'род,ед'}]]
мокрыми трусами	[['мокрый', {'твор,мн'}], ['трусы', {'твор,мн'}]]
мокрой работы	[['мокрый', {'дат,ед', 'твор,ед', 'род,ед', 'пр,ед'}], ['работа', {'вин,мн', 'род,ед', 'им,мн'}]]
мокрая ладонь	[['мокрый', {'им,ед'}], ['ладонь', {'вин,ед', 'им,ед'}]]
мокрым пальцем	[['мокрый', {'твор,ед', 'дат,мн'}], ['палец', {'твор,ед'}]]
мокрые рукавицы	[['мокрый', {'вин,мн', 'им,мн'}], ['рукавица', {'вин,мн', 'род,ед', 'им,мн'}]]
мокрые галки	[['мокрый', {'вин,мн', 'им,мн'}], ['галка', {'род,ед', 'им,мн'}]]
мокрых усов	[['мокрый', {'род,мн', 'вин,мн', 'пр,мн'}], ['ус', {'род,мн', 'им,ед'}]]
мокрую гальку	[['мокрый', {'вин,ед'}], ['галька', {'вин,ед', 'дат,ед'}]]
мокрого протравливания	[['мокрый', {'вин,ед', 'род,ед'}], ['протравливание', {'вин,мн', 'род,ед', 'им,мн'}]]
мокрой траве	[['мокрый', {'дат,ед', 'твор,ед', 'род,ед', 'пр,ед'}], ['трава', {'дат,ед', 'пр,ед'}]]
мокрый гранит	[['мокрый', {'вин,ед', 'им,ед'}], ['гранит', {'вин,ед', 'род,мн', 'вин,мн', 'непрош,ед,изъяв,3-л', 'им,ед'}]]
мокрое бревно	[['мокрый', {'вин,ед', 'им,ед'}], ['бревно', {'вин,ед', 'им,ед'}]]
мокрые ветви	[['мокрый', {'вин,мн', 'им,мн'}], ['ветвь', {'дат,ед', 'вин,мн', 'род,ед', 'им,мн', 'пр,ед'}]]
мокрым небом	[['мокрый', {'твор,ед', 'дат,мн'}], ['небо', {'твор,ед'}]]
мокрымъ полотенцемъ	[['мокрый', {'твор,ед', 'дат,мн'}], ['полотенце', {'твор,ед'}]]
мокрой сепарации	[['мокрый', {'дат,ед', 'твор,ед', 'род,ед', 'пр,ед'}], ['сепарация', {'дат,ед', 'вин,мн', 'род,ед', 'им,мн', 'пр,ед'}]]
мокрое грохочение	[['мокрый', {'вин,ед', 'им,ед'}], ['грохочение', {'вин,ед', 'им,ед'}]]
мокрым столиком	[['мокрый', {'твор,ед', 'дат,мн'}], ['столик', {'пр,ед,полн,муж', 'твор,ед', 'пр,ед,полн,сред'}]]
мокрого следа	[['мокрый', {'вин,ед', 'род,ед'}], ['след', {'род,ед'}]]
мокрых опилках	[['мокрый', {'род,мн', 'вин,мн', 'пр,мн'}], ['опилки', {'пр,мн'}]]
мокрой хвоей	[['мокрый', {'дат,ед', 'твор,ед', 'род,ед', 'пр,ед'}], ['хвоя', {'твор,ед'}]]
мокрой зеленью	[['мокрый', {'дат,ед', 'твор,ед', 'род,ед', 'пр,ед'}], ['зелень', {'твор,ед'}]]
мокрый год	[['мокрый', {'вин,ед', 'им,ед'}], ['год', {'вин,ед', 'им,ед'}]]
мокрых пеленках	[['мокрый', {'род,мн', 'вин,мн', 'пр,мн'}], ['пеленка', {'пр,мн'}]]
мокрым сукном	[['мокрый', {'твор,ед', 'дат,мн'}], ['сукно', {'твор,ед'}]]
мокрым задом	[['мокрый', {'твор,ед', 'дат,мн'}], ['зад', {'', 'твор,ед'}]]
мокрых ступеньках	[['мокрый', {'род,мн', 'вин,мн', 'пр,мн'}], ['ступенька', {'пр,мн'}]]
мокрому саду	[['мокрый', {'дат,ед'}], ['сад', {'местн,ед', 'дат,ед'}]]
мокрые клочья	[['мокрый', {'вин,мн', 'им,мн'}], ['клок', {'вин,мн', 'им,мн'}]]
мокром брезенте	[['мокрый', {'пр,ед'}], ['брезент', {'пр,ед'}]]
мокрых плащей	[['мокрый', {'род,мн', 'вин,мн', 'пр,мн'}], ['плащ', {'род,мн'}]]
мокрым методом	[['мокрый', {'твор,ед', 'дат,мн'}], ['метод', {'твор,ед'}]]
мокрым процессом	[['мокрый', {'твор,ед', 'дат,мн'}], ['процесс', {'твор,ед'}]]
мокрого метода	[['мокрый', {'вин,ед', 'род,ед'}], ['метод', {'род,ед', 'им,ед'}]]
мокрой простыней	[['мокрый', {'дат,ед', 'твор,ед', 'род,ед', 'пр,ед'}], ['простыня', {'род,мн', 'твор,ед'}]]
мокрых долах	[['мокрый', {'род,мн', 'вин,мн', 'пр,мн'}], ['дол', {'пр,мн'}]]
мокрых камней	[['мокрый', {'род,мн', 'вин,мн', 'пр,мн'}], ['камень', {'род,мн'}]]
мокрым озолением	[['мокрый', {'твор,ед', 'дат,мн'}], ['озоление', {'твор,ед'}]]
мокрого окна	[['мокрый', {'вин,ед', 'род,ед'}], ['окно', {'вин,мн', 'род,ед', 'им,мн'}]]
мокрый способы	[['мокрый', {'вин,ед', 'им,ед'}], ['способ', {'вин,мн', 'им,мн'}]]
мокром фартуке	[['мокрый', {'пр,ед'}], ['фартук', {'пр,ед'}]]
мокрых простыней	[['мокрый', {'род,мн', 'вин,мн', 'пр,мн'}], ['простыня', {'род,мн', 'твор,ед'}]]
мокрых опилок	[['мокрый', {'род,мн', 'вин,мн', 'пр,мн'}], ['опилки', {'род,мн'}]]
мокрую ногу	[['мокрый', {'вин,ед'}], ['нога', {'вин,ед'}]]
мокрого капюшона	[['мокрый', {'вин,ед', 'род,ед'}], ['капюшон', {'род,ед'}]]
мокрый носок	[['мокрый', {'вин,ед', 'им,ед'}], ['носок', {'вин,ед', 'род,мн', 'ед,кр,муж', 'им,ед'}]]
мокрые дорожки	[['мокрый', {'вин,мн', 'им,мн'}], ['дорожка', {'вин,мн', 'род,ед', 'им,мн'}]]
мокрый палец	[['мокрый', {'вин,ед', 'им,ед'}], ['палец', {'вин,ед', 'им,ед'}]]
мокрая смородина	[['мокрый', {'им,ед'}], ['смородина', {'вин,ед', 'род,ед', 'им,ед'}]]
мокрая ресница	[['мокрый', {'им,ед'}], ['ресница', {'им,ед'}]]
мокром полотенце	[['мокрый', {'пр,ед'}], ['полотенце', {'вин,ед', 'им,ед', 'пр,ед'}]]
мокрую рожь	[['мокрый', {'вин,ед'}], ['рожь', {'вин,ед', 'им,ед'}]]
мокрой тряпки	[['мокрый', {'дат,ед', 'твор,ед', 'род,ед', 'пр,ед'}], ['тряпка', {'вин,мн', 'род,ед', 'им,мн'}]]
мокрую швабру	[['мокрый', {'вин,ед'}], ['швабра', {'вин,ед'}]]
мокрые куры	[['мокрый', {'вин,мн', 'им,мн'}], ['курица', {'род,ед', 'им,мн', 'вин,мн'}]]
мокрых зонтиков	[['мокрый', {'род,мн', 'вин,мн', 'пр,мн'}], ['зонтик', {'род,мн'}]]
мокрыми кудрями	[['мокрый', {'твор,мн'}], ['кудри', {'твор,мн'}]]
мокрыми комками	[['мокрый', {'твор,мн'}], ['комок', {'твор,мн'}]]
мокрая резина	[['мокрый', {'им,ед'}], ['резина', {'вин,ед', 'род,ед', 'им,ед'}]]
мокрую шею	[['мокрый', {'вин,ед'}], ['шея', {'вин,ед'}]]
мокрые ели	[['мокрый', {'вин,мн', 'им,мн'}], ['есть=V,несов,пе=прош,мн,изъяв', {'прош,мн,изъяв', 'род,ед', 'пр,ед', 'вин,мн', 'им,мн', 'дат,ед'}]]
мокрой гнилью	[['мокрый', {'дат,ед', 'твор,ед', 'род,ед', 'пр,ед'}], ['гниль', {'твор,ед', 'дат,ед'}]]
мокрый полушубок	[['мокрый', {'вин,ед', 'им,ед'}], ['полушубок', {'вин,ед', 'им,ед'}]]
мокрую веревку	[['мокрый', {'вин,ед'}], ['веревка', {'вин,ед'}]]
мокрый полог	[['мокрый', {'вин,ед', 'им,ед'}], ['полог', {'вин,ед', 'ед,кр,муж', 'им,ед'}]]
мокрых тротуарах	[['мокрый', {'род,мн', 'вин,мн', 'пр,мн'}], ['тротуар', {'пр,мн'}]]
мокрых электрофильтрах	[['мокрый', {'род,мн', 'вин,мн', 'пр,мн'}], ['электрофильтр', {'пр,мн'}]]
мокрую брусчатку	[['мокрый', {'вин,ед'}], ['брусчатка', {'вин,ед'}]]
мокрому шоссе	[['мокрый', {'дат,ед'}], ['шоссе', {'род,ед', 'пр,ед', 'род,мн', 'твор,ед', 'вин,мн', 'им,мн', 'дат,мн', 'им,ед', 'твор,мн', 'вин,ед', 'пр,мн', 'дат,ед'}]]
мокрым обогащением	[['мокрый', {'твор,ед', 'дат,мн'}], ['обогащение', {'твор,ед'}]]
мокрой веткой	[['мокрый', {'дат,ед', 'твор,ед', 'род,ед', 'пр,ед'}], ['ветка', {'твор,ед'}]]
мокрые пятна	[['мокрый', {'вин,мн', 'им,мн'}], ['пятно', {'вин,мн', 'род,ед', 'им,мн'}]]
мокрая губа	[['мокрый', {'им,ед'}], ['губа', {'им,ед'}]]
мокрой палубы	[['мокрый', {'дат,ед', 'твор,ед', 'род,ед', 'пр,ед'}], ['палуба', {'вин,мн', 'род,ед', 'им,мн'}]]
мокром тумане	[['мокрый', {'пр,ед'}], ['туман', {'пр,ед'}]]
мокрые штанишки	[['мокрый', {'вин,мн', 'им,мн'}], ['штанишки', {'вин,мн', 'им,мн'}]]
мокрые перышки	[['мокрый', {'вин,мн', 'им,мн'}], ['перышко', {'вин,мн', 'им,мн'}]]
мокрому зазимку	[['мокрый', {'дат,ед'}], ['зазимок', {'дат,ед'}]]
мокрых ресниц	[['мокрый', {'род,мн', 'вин,мн', 'пр,мн'}], ['ресница', {'род,мн'}]]
мокром процессе	[['мокрый', {'пр,ед'}], ['процесс', {'пр,ед'}]]
мокрыми космами	[['мокрый', {'твор,мн'}], ['космы', {'твор,мн'}]]
мокрых стеклах	[['мокрый', {'род,мн', 'вин,мн', 'пр,мн'}], ['стекло', {'пр,мн'}]]
мокрой шинелью	[['мокрый', {'дат,ед', 'твор,ед', 'род,ед', 'пр,ед'}], ['шинель', {'твор,ед'}]]
мокрого угля	[['мокрый', {'вин,ед', 'род,ед'}], ['уголь', {'род,ед'}]]
мокрой соломой	[['мокрый', {'дат,ед', 'твор,ед', 'род,ед', 'пр,ед'}], ['солома', {'твор,ед'}]]
мокром асфальте	[['мокрый', {'пр,ед'}], ['асфальт', {'пр,ед'}]]
мокрой глине	[['мокрый', {'дат,ед', 'твор,ед', 'род,ед', 'пр,ед'}], ['глина', {'дат,ед', 'пр,ед'}]]
мокрой платформы	[['мокрый', {'дат,ед', 'твор,ед', 'род,ед', 'пр,ед'}], ['платформа', {'вин,мн', 'род,ед', 'им,мн'}]]
мокром снегу	[['мокрый', {'пр,ед'}], ['снег', {'парт,ед', 'местн,ед', 'дат,ед'}]]
мокрую пленку	[['мокрый', {'вин,ед'}], ['пленка', {'вин,ед'}]]
мокрыми вихрами	[['мокрый', {'твор,мн'}], ['вихор', {'твор,мн'}]]
мокрой буркой	[['мокрый', {'дат,ед', 'твор,ед', 'род,ед', 'пр,ед'}], ['бурка', {'твор,ед'}]]
мокрый угол	[['мокрый', {'вин,ед', 'им,ед'}], ['угол', {'вин,ед', 'им,ед'}]]
мокрую спину	[['мокрый', {'вин,ед'}], ['спина', {'вин,ед', 'дат,ед'}]]
мокрые ветры	[['мокрый', {'вин,мн', 'им,мн'}], ['ветер', {'вин,мн', 'им,мн'}]]
мокрой овчины	[['мокрый', {'дат,ед', 'твор,ед', 'род,ед', 'пр,ед'}], ['овчина', {'вин,мн', 'род,ед', 'им,мн'}]]
мокрых мостках	[['мокрый', {'род,мн', 'вин,мн', 'пр,мн'}], ['мостки', {'пр,мн'}]]
мокрого листа	[['мокрый', {'вин,ед', 'род,ед'}], ['лист', {'род,ед'}]]
мокрая метелица	[['мокрый', {'им,ед'}], ['метелица', {'им,ед'}]]
мокрый пакет	[['мокрый', {'вин,ед', 'им,ед'}], ['пакет', {'вин,ед', 'им,ед'}]]
мокрой тьмы	[['мокрый', {'дат,ед', 'твор,ед', 'род,ед', 'пр,ед'}], ['тьма', {'вин,мн', 'род,ед', 'им,мн'}]]
мокрой дорогой	[['мокрый', {'дат,ед', 'твор,ед', 'род,ед', 'пр,ед'}], ['дорогой=A=вин,ед,полн,муж,неод', {'вин,ед,полн,муж,неод', 'твор,ед', 'им,ед', 'им,ед,полн,муж', 'род,ед,полн,жен', 'твор,ед,полн,жен', 'пр,ед,полн,жен', 'дат,ед,полн,жен'}]]
мокрые шпалы	[['мокрый', {'вин,мн', 'им,мн'}], ['шпала', {'вин,мн', 'род,ед', 'им,мн'}]]
мокрой горою	[['мокрый', {'дат,ед', 'твор,ед', 'род,ед', 'пр,ед'}], ['гора', {'твор,ед'}]]
мокрой крышей	[['мокрый', {'дат,ед', 'твор,ед', 'род,ед', 'пр,ед'}], ['крыша', {'твор,ед'}]]
мокрым крышам	[['мокрый', {'твор,ед', 'дат,мн'}], ['крыша', {'дат,мн'}]]
мокрой стойке	[['мокрый', {'дат,ед', 'твор,ед', 'род,ед', 'пр,ед'}], ['стойка', {'дат,ед', 'пр,ед'}]]
мокрый кусок	[['мокрый', {'вин,ед', 'им,ед'}], ['кусок', {'вин,ед', 'им,ед'}]]
мокрые кони	[['мокрый', {'вин,мн', 'им,мн'}], ['конь', {'им,мн'}]]
мокрой землей	[['мокрый', {'дат,ед', 'твор,ед', 'род,ед', 'пр,ед'}], ['земля', {'твор,ед'}]]
мокрымъ путемъ	[['мокрый', {'твор,ед', 'дат,мн'}], ['путем=PR=', {'', 'твор,ед'}]]
мокрый асфальт	[['мокрый', {'вин,ед', 'им,ед'}], ['асфальт', {'вин,ед', 'им,ед'}]]
мокрой свежестью	[['мокрый', {'дат,ед', 'твор,ед', 'род,ед', 'пр,ед'}], ['свежесть', {'твор,ед'}]]
мокрого формования	[['мокрый', {'вин,ед', 'род,ед'}], ['формование', {'вин,мн', 'род,ед', 'им,мн'}]]
мокрой набережной	[['мокрый', {'дат,ед', 'твор,ед', 'род,ед', 'пр,ед'}], ['набережная', {'дат,ед', 'твор,ед', 'род,ед', 'пр,ед'}]]
мокрой голове	[['мокрый', {'дат,ед', 'твор,ед', 'род,ед', 'пр,ед'}], ['голова', {'дат,ед', 'пр,ед'}]]
мокрыми подмышками	[['мокрый', {'твор,мн'}], ['подмышка', {'твор,мн'}]]
мокрые крылья	[['мокрый', {'вин,мн', 'им,мн'}], ['крыло', {'вин,мн', 'им,мн'}]]
мокрых цехов	[['мокрый', {'род,мн', 'вин,мн', 'пр,мн'}], ['цех', {'род,мн'}]]
мокрое пальто	[['мокрый', {'вин,ед', 'им,ед'}], ['пальто', {'род,ед', 'пр,ед', 'род,мн', 'твор,ед', 'вин,мн', 'им,мн', 'дат,мн', 'им,ед', 'твор,мн', 'вин,ед', 'пр,мн', 'дат,ед'}]]
мокрый пучок	[['мокрый', {'вин,ед', 'им,ед'}], ['пучок', {'вин,ед', 'им,ед'}]]
мокрые ступеньки	[['мокрый', {'вин,мн', 'им,мн'}], ['ступенька', {'вин,мн', 'род,ед', 'им,мн'}]]
мокрым помолом	[['мокрый', {'твор,ед', 'дат,мн'}], ['помол', {'твор,ед'}]]
мокрых брюках	[['мокрый', {'род,мн', 'вин,мн', 'пр,мн'}], ['брюки', {'пр,мн'}]]
мокрая зелень	[['мокрый', {'им,ед'}], ['зелень', {'вин,ед', 'им,ед'}]]
мокрые корни	[['мокрый', {'вин,мн', 'им,мн'}], ['корень', {'вин,мн', 'им,мн'}]]
мокром дождевике	[['мокрый', {'пр,ед'}], ['дождевик', {'пр,ед'}]]
мокрых штанишках	[['мокрый', {'род,мн', 'вин,мн', 'пр,мн'}], ['штанишки', {'пр,мн'}]]
мокрым лбам	[['мокрый', {'твор,ед', 'дат,мн'}], ['лоб', {'дат,мн'}]]
мокрые стволы	[['мокрый', {'вин,мн', 'им,мн'}], ['ствол', {'вин,мн', 'им,мн'}]]
мокрая метель	[['мокрый', {'им,ед'}], ['метель', {'вин,ед', 'им,ед'}]]
мокрого коня	[['мокрый', {'вин,ед', 'род,ед'}], ['конь', {'вин,ед', 'род,ед'}]]
мокрая дорога	[['мокрый', {'им,ед'}], ['дорога', {'ед,кр,жен', 'им,ед'}]]
мокрые ресницы	[['мокрый', {'вин,мн', 'им,мн'}], ['ресница', {'вин,мн', 'род,ед', 'им,мн'}]]
мокрый хвост	[['мокрый', {'вин,ед', 'им,ед'}], ['хвост', {'вин,ед', 'им,ед'}]]
мокрому грунту	[['мокрый', {'дат,ед'}], ['грунт', {'местн,ед', 'дат,ед'}]]
мокрых рельсов	[['мокрый', {'род,мн', 'вин,мн', 'пр,мн'}], ['рельс', {'род,мн', 'ед,кр,муж'}]]
мокрой осени	[['мокрый', {'дат,ед', 'твор,ед', 'род,ед', 'пр,ед'}], ['осень', {'род,ед', 'пр,ед', 'вин,мн', 'им,мн', 'ед,пов,2-л,сов', 'дат,ед'}]]
мокрая шлифовка	[['мокрый', {'им,ед'}], ['шлифовка', {'им,ед'}]]
мокрую крышу	[['мокрый', {'вин,ед'}], ['крыша', {'вин,ед'}]]
мокрые круги	[['мокрый', {'вин,мн', 'им,мн'}], ['круг', {'вин,мн', 'им,мн'}]]
мокрых ногах	[['мокрый', {'род,мн', 'вин,мн', 'пр,мн'}], ['нога', {'пр,мн'}]]
мокрым травам	[['мокрый', {'твор,ед', 'дат,мн'}], ['трава', {'дат,мн'}]]
мокрых губах	[['мокрый', {'род,мн', 'вин,мн', 'пр,мн'}], ['губа', {'род,мн', 'пр,мн'}]]
мокрые джинсы	[['мокрый', {'вин,мн', 'им,мн'}], ['джинсы', {'вин,мн', 'им,мн', 'род,ед'}]]
мокрыми полушубками	[['мокрый', {'твор,мн'}], ['полушубок', {'твор,мн'}]]
мокрого пылеподавления	[['мокрый', {'вин,ед', 'род,ед'}], ['пылеподавление', {'вин,мн', 'род,ед', 'им,мн'}]]
мокрой минерализации	[['мокрый', {'дат,ед', 'твор,ед', 'род,ед', 'пр,ед'}], ['минерализация', {'дат,ед', 'вин,мн', 'род,ед', 'им,мн', 'пр,ед'}]]
мокрых стен	[['мокрый', {'род,мн', 'вин,мн', 'пр,мн'}], ['стена', {'род,мн', 'вин,ед', 'им,ед'}]]
мокрые дрова	[['мокрый', {'вин,мн', 'им,мн'}], ['дрова', {'вин,мн', 'им,мн'}]]
мокрый бок	[['мокрый', {'вин,ед', 'им,ед'}], ['бок', {'вин,ед', 'им,ед'}]]
мокрые собаки	[['мокрый', {'вин,мн', 'им,мн'}], ['собака', {'род,ед', 'им,мн'}]]
мокрой зимы	[['мокрый', {'дат,ед', 'твор,ед', 'род,ед', 'пр,ед'}], ['зима', {'вин,мн', 'род,ед', 'им,мн'}]]
мокром лбу	[['мокрый', {'пр,ед'}], ['лоб', {'местн,ед', 'дат,ед'}]]
мокрые избы	[['мокрый', {'вин,мн', 'им,мн'}], ['изба', {'вин,мн', 'род,ед', 'им,мн'}]]
мокрыми щеками	[['мокрый', {'твор,мн'}], ['щека', {'твор,мн'}]]
мокрая скамья	[['мокрый', {'им,ед'}], ['скамья', {'им,ед'}]]
мокрых скамейках	[['мокрый', {'род,мн', 'вин,мн', 'пр,мн'}], ['скамейка', {'пр,мн'}]]
мокрому трению	[['мокрый', {'дат,ед'}], ['трение', {'дат,ед'}]]
мокрых кур	[['мокрый', {'род,мн', 'вин,мн', 'пр,мн'}], ['курица', {'род,мн', 'вин,мн', 'им,ед'}]]
мокрой части	[['мокрый', {'дат,ед', 'твор,ед', 'род,ед', 'пр,ед'}], ['часть', {'род,ед', 'пр,ед', 'ед,пов,2-л', 'вин,мн', 'им,мн', 'дат,ед'}]]
мокрый зонтик	[['мокрый', {'вин,ед', 'им,ед'}], ['зонтик', {'вин,ед', 'им,ед'}]]
мокрые лохмотья	[['мокрый', {'вин,мн', 'им,мн'}], ['лохмотья', {'вин,мн', 'им,мн'}]]
мокрому способу	[['мокрый', {'дат,ед'}], ['способ', {'дат,ед'}]]
мокрыми заборами	[['мокрый', {'твор,мн'}], ['забор', {'твор,мн'}]]
мокрой тайге	[['мокрый', {'дат,ед', 'твор,ед', 'род,ед', 'пр,ед'}], ['тайга', {'дат,ед', 'пр,ед'}]]
мокрые извозчики	[['мокрый', {'вин,мн', 'им,мн'}], ['извозчик', {'им,мн'}]]
мокрых домов	[['мокрый', {'род,мн', 'вин,мн', 'пр,мн'}], ['дом', {'род,мн', 'ед,кр,муж'}]]
мокрого волочения	[['мокрый', {'вин,ед', 'род,ед'}], ['волочение', {'вин,мн', 'род,ед', 'им,мн'}]]
мокрой грануляции	[['мокрый', {'дат,ед', 'твор,ед', 'род,ед', 'пр,ед'}], ['грануляция', {'дат,ед', 'вин,мн', 'род,ед', 'им,мн', 'пр,ед'}]]
мокрая ткань	[['мокрый', {'им,ед'}], ['ткань', {'вин,ед', 'им,ед'}]]
мокрое полотно	[['мокрый', {'вин,ед', 'им,ед'}], ['полотно', {'вин,ед', 'им,ед'}]]
мокрого белья	[['мокрый', {'вин,ед', 'род,ед'}], ['белье', {'род,ед'}]]
мокрое мыло	[['мокрый', {'вин,ед', 'им,ед'}], ['мыло', {'вин,ед', 'им,ед', 'прош,ед,изъяв,сред'}]]
мокрой бумаги	[['мокрый', {'дат,ед', 'твор,ед', 'род,ед', 'пр,ед'}], ['бумага', {'вин,мн', 'род,ед', 'им,мн'}]]
мокрого котенка	[['мокрый', {'вин,ед', 'род,ед'}], ['котенок', {'вин,ед', 'род,ед'}]]
мокрых брюк	[['мокрый', {'род,мн', 'вин,мн', 'пр,мн'}], ['брюки', {'род,мн'}]]
мокрого прядения	[['мокрый', {'вин,ед', 'род,ед'}], ['прядение', {'вин,мн', 'род,ед', 'им,мн'}]]
мокрой пашне	[['мокрый', {'дат,ед', 'твор,ед', 'род,ед', 'пр,ед'}], ['пашня', {'дат,ед', 'пр,ед'}]]
мокрого места	[['мокрый', {'вин,ед', 'род,ед'}], ['место', {'вин,мн', 'род,ед', 'им,мн'}]]
мокрыми усиками	[['мокрый', {'твор,мн'}], ['усик', {'твор,мн'}]]
мокрый пудель	[['мокрый', {'вин,ед', 'им,ед'}], ['пудель', {'им,ед'}]]
мокром воздухе	[['мокрый', {'пр,ед'}], ['воздух', {'пр,ед'}]]
мокрого петуха	[['мокрый', {'вин,ед', 'род,ед'}], ['петух', {'вин,ед', 'род,ед'}]]
мокрых рубахах	[['мокрый', {'род,мн', 'вин,мн', 'пр,мн'}], ['рубаха', {'пр,мн'}]]
мокрое дерево	[['мокрый', {'вин,ед', 'им,ед'}], ['дерево', {'вин,ед', 'им,ед'}]]
мокрыми рукавами	[['мокрый', {'твор,мн'}], ['рукав', {'твор,мн'}]]
мокрого скруббера	[['мокрый', {'вин,ед', 'род,ед'}], ['скруббер', {'вин,мн', 'род,ед', 'им,мн'}]]
мокрой столицы	[['мокрый', {'дат,ед', 'твор,ед', 'род,ед', 'пр,ед'}], ['столица', {'вин,мн', 'род,ед', 'им,мн'}]]
мокром ветре	[['мокрый', {'пр,ед'}], ['ветер', {'пр,ед'}]]
мокрых пеленок	[['мокрый', {'род,мн', 'вин,мн', 'пр,мн'}], ['пеленка', {'род,мн'}]]
мокрые ладони	[['мокрый', {'вин,мн', 'им,мн'}], ['ладонь', {'дат,ед', 'вин,мн', 'род,ед', 'им,мн', 'пр,ед'}]]
мокрому размолу	[['мокрый', {'дат,ед'}], ['размол', {'дат,ед'}]]
мокрым лесам	[['мокрый', {'твор,ед', 'дат,мн'}], ['лес', {'дат,мн'}]]
мокрыми лугами	[['мокрый', {'твор,мн'}], ['луг', {'твор,мн'}]]
мокрый размол	[['мокрый', {'вин,ед', 'им,ед'}], ['размол', {'вин,ед', 'им,ед'}]]
мокрых облаках	[['мокрый', {'род,мн', 'вин,мн', 'пр,мн'}], ['облако', {'пр,мн'}]]
мокрого холода	[['мокрый', {'вин,ед', 'род,ед'}], ['холод', {'вин,мн', 'род,ед', 'им,мн'}]]
мокрой луговине	[['мокрый', {'дат,ед', 'твор,ед', 'род,ед', 'пр,ед'}], ['луговина', {'дат,ед', 'пр,ед'}]]
мокрую тьму	[['мокрый', {'вин,ед'}], ['тьма', {'вин,ед'}]]
мокрым режимом	[['мокрый', {'твор,ед', 'дат,мн'}], ['режим', {'твор,ед', 'непрош,пр,ед,прич,полн,муж,страд', 'непрош,пр,ед,прич,полн,сред,страд'}]]
мокрыми дорожками	[['мокрый', {'твор,мн'}], ['дорожка', {'твор,мн'}]]
мокрой броне	[['мокрый', {'дат,ед', 'твор,ед', 'род,ед', 'пр,ед'}], ['броня', {'дат,ед', 'пр,ед'}]]
мокрые вороны	[['мокрый', {'вин,мн', 'им,мн'}], ['ворона', {'род,ед', 'им,мн'}]]
мокрому белью	[['мокрый', {'дат,ед'}], ['белье', {'твор,ед', 'дат,ед'}]]
мокром лесу	[['мокрый', {'пр,ед'}], ['лес', {'вин,ед', 'парт,ед', 'местн,ед', 'дат,ед'}]]
мокрые лапы	[['мокрый', {'вин,мн', 'им,мн'}], ['лапа', {'вин,мн', 'род,ед', 'им,мн'}]]
мокрые отпечатки	[['мокрый', {'вин,мн', 'им,мн'}], ['отпечаток', {'вин,мн', 'им,мн'}]]
мокрые веки	[['мокрый', {'вин,мн', 'им,мн'}], ['веко', {'вин,мн', 'им,мн'}]]
мокрому лбу	[['мокрый', {'дат,ед'}], ['лоб', {'местн,ед', 'дат,ед'}]]
мокрого кручения	[['мокрый', {'вин,ед', 'род,ед'}], ['кручение', {'вин,мн', 'род,ед', 'им,мн'}]]
мокрыми подолами	[['мокрый', {'твор,мн'}], ['подол', {'твор,мн'}]]
мокрую бутылочку	[['мокрый', {'вин,ед'}], ['бутылочка', {'вин,ед'}]]
мокрый конец	[['мокрый', {'вин,ед', 'им,ед'}], ['конец', {'вин,ед', 'им,ед'}]]
мокрой головой	[['мокрый', {'дат,ед', 'твор,ед', 'род,ед', 'пр,ед'}], ['голова', {'дат,ед', 'твор,ед', 'род,ед', 'пр,ед'}]]
мокрой отделки	[['мокрый', {'дат,ед', 'твор,ед', 'род,ед', 'пр,ед'}], ['отделка', {'вин,мн', 'род,ед', 'им,мн'}]]
мокрому платью	[['мокрый', {'дат,ед'}], ['платье', {'дат,ед'}]]
мокрым делам	[['мокрый', {'твор,ед', 'дат,мн'}], ['дело', {'дат,мн'}]]
мокрым щебнем	[['мокрый', {'твор,ед', 'дат,мн'}], ['щебень', {'твор,ед'}]]
мокрым мехом	[['мокрый', {'твор,ед', 'дат,мн'}], ['мех', {'твор,ед'}]]
мокрым рылом	[['мокрый', {'твор,ед', 'дат,мн'}], ['рыло', {'твор,ед'}]]
мокрое поле	[['мокрый', {'вин,ед', 'им,ед'}], ['поле', {'вин,ед', 'дат,ед', 'им,ед', 'пр,ед'}]]
мокрый мрак	[['мокрый', {'вин,ед', 'им,ед'}], ['мрак', {'вин,ед', 'им,ед'}]]
мокрым кнутом	[['мокрый', {'твор,ед', 'дат,мн'}], ['кнут', {'твор,ед'}]]
мокрый ковер	[['мокрый', {'вин,ед', 'им,ед'}], ['ковер', {'вин,ед', 'им,ед'}]]
мокрые ступни	[['мокрый', {'вин,мн', 'им,мн'}], ['ступня', {'вин,мн', 'род,ед', 'им,мн'}]]
мокрой рогожей	[['мокрый', {'дат,ед', 'твор,ед', 'род,ед', 'пр,ед'}], ['рогожа', {'твор,ед'}]]
мокрой постели	[['мокрый', {'дат,ед', 'твор,ед', 'род,ед', 'пр,ед'}], ['постель', {'род,ед', 'пр,ед', 'вин,мн', 'им,мн', 'ед,пов,2-л,сов', 'дат,ед'}]]
мокрой шерстью	[['мокрый', {'дат,ед', 'твор,ед', 'род,ед', 'пр,ед'}], ['шерсть', {'твор,ед'}]]
мокрая глина	[['мокрый', {'им,ед'}], ['глина', {'им,ед'}]]
мокрой копной	[['мокрый', {'дат,ед', 'твор,ед', 'род,ед', 'пр,ед'}], ['копна', {'твор,ед'}]]
мокрого льда	[['мокрый', {'вин,ед', 'род,ед'}], ['лед', {'род,ед'}]]
мокрой сероочистки	[['мокрый', {'дат,ед', 'твор,ед', 'род,ед', 'пр,ед'}], ['сероочистка', {'вин,мн', 'род,ед', 'им,мн'}]]
мокрого дела	[['мокрый', {'вин,ед', 'род,ед'}], ['дело', {'прош,ед,изъяв,жен,сов', 'вин,мн', 'род,ед', 'им,мн'}]]
мокрого роста	[['мокрый', {'вин,ед', 'род,ед'}], ['рост', {'вин,мн', 'род,ед', 'им,мн'}]]
мокрым паром	[['мокрый', {'твор,ед', 'дат,мн'}], ['пар', {'вин,ед', 'твор,ед', 'им,ед'}]]
мокрую штукатурку	[['мокрый', {'вин,ед'}], ['штукатурка', {'вин,ед'}]]
мокрые плечи	[['мокрый', {'вин,мн', 'им,мн'}], ['плечо', {'вин,мн', 'им,мн'}]]
мокрую папиросу	[['мокрый', {'вин,ед'}], ['папироса', {'вин,ед'}]]
мокром купальнике	[['мокрый', {'пр,ед'}], ['купальник', {'пр,ед'}]]
мокрой шубе	[['мокрый', {'дат,ед', 'твор,ед', 'род,ед', 'пр,ед'}], ['шуба', {'дат,ед', 'пр,ед'}]]
мокрыми овчинами	[['мокрый', {'твор,мн'}], ['овчина', {'твор,мн'}]]
мокрый щит	[['мокрый', {'вин,ед', 'им,ед'}], ['щит', {'вин,ед', 'им,ед'}]]
мокрую ладонь	[['мокрый', {'вин,ед'}], ['ладонь', {'вин,ед', 'им,ед'}]]
мокрых болот	[['мокрый', {'род,мн', 'вин,мн', 'пр,мн'}], ['болото', {'род,мн', 'им,ед'}]]
мокрый посол	[['мокрый', {'вин,ед', 'им,ед'}], ['посол', {'вин,ед', 'им,ед'}]]
мокрая весна	[['мокрый', {'им,ед'}], ['весна', {'им,ед'}]]
мокрыми местами	[['мокрый', {'твор,мн'}], ['место', {'твор,мн', ''}]]
мокрый листок	[['мокрый', {'вин,ед', 'им,ед'}], ['листок', {'вин,ед', 'им,ед'}]]
мокрых мостовых	[['мокрый', {'род,мн', 'вин,мн', 'пр,мн'}], ['мостовая', {'род,мн,полн', 'род,мн', 'вин,мн,полн,од', 'вин,мн,од', 'вин,мн', 'пр,мн,полн', 'пр,мн'}]]
мокрые бабы	[['мокрый', {'вин,мн', 'им,мн'}], ['баба', {'род,ед', 'им,мн', 'вин,мн'}]]
мокрой одежде	[['мокрый', {'дат,ед', 'твор,ед', 'род,ед', 'пр,ед'}], ['одежда', {'дат,ед', 'пр,ед'}]]
мокрым брезентом	[['мокрый', {'твор,ед', 'дат,мн'}], ['брезент', {'твор,ед'}]]
мокрых спинах	[['мокрый', {'род,мн', 'вин,мн', 'пр,мн'}], ['спина', {'пр,мн'}]]
мокрым бокам	[['мокрый', {'твор,ед', 'дат,мн'}], ['бок', {'дат,мн'}]]
мокром методе	[['мокрый', {'пр,ед'}], ['метод', {'дат,ед', 'пр,ед'}]]
мокрое крыльцо	[['мокрый', {'вин,ед', 'им,ед'}], ['крыльцо', {'вин,ед', 'им,ед'}]]
мокрый стакан	[['мокрый', {'вин,ед', 'им,ед'}], ['стакан', {'вин,ед', 'им,ед'}]]
мокрые ноздри	[['мокрый', {'вин,мн', 'им,мн'}], ['ноздря', {'вин,мн', 'род,ед', 'им,мн'}]]
мокрой гимнастерке	[['мокрый', {'дат,ед', 'твор,ед', 'род,ед', 'пр,ед'}], ['гимнастерка', {'дат,ед', 'пр,ед'}]]
мокрых портянках	[['мокрый', {'род,мн', 'вин,мн', 'пр,мн'}], ['портянка', {'пр,мн'}]]
мокрого воздуха	[['мокрый', {'вин,ед', 'род,ед'}], ['воздух', {'род,ед'}]]
мокрые солончаки	[['мокрый', {'вин,мн', 'им,мн'}], ['солончак', {'вин,мн', 'им,мн'}]]
мокрый табак	[['мокрый', {'вин,ед', 'им,ед'}], ['табак', {'вин,ед', 'им,ед'}]]
мокрый бетон	[['мокрый', {'вин,ед', 'им,ед'}], ['бетон', {'вин,ед', 'им,ед'}]]
мокрой скале	[['мокрый', {'дат,ед', 'твор,ед', 'род,ед', 'пр,ед'}], ['скала', {'дат,ед', 'пр,ед'}]]
мокрыя губы	[['мокрый', {'устар,вин', 'устар,им'}], ['губа', {'вин,мн', 'род,ед', 'им,мн'}]]
мокрыми лицами	[['мокрый', {'твор,мн'}], ['лицо', {'твор,мн'}]]
мокрой скатертью	[['мокрый', {'дат,ед', 'твор,ед', 'род,ед', 'пр,ед'}], ['скатерть', {'твор,ед'}]]
мокрый шелк	[['мокрый', {'вин,ед', 'им,ед'}], ['шелк', {'вин,ед', 'им,ед'}]]
мокрым фартуком	[['мокрый', {'твор,ед', 'дат,мн'}], ['фартук', {'твор,ед'}]]
мокрых низинах	[['мокрый', {'род,мн', 'вин,мн', 'пр,мн'}], ['низина', {'пр,мн'}]]
мокрым скалам	[['мокрый', {'твор,ед', 'дат,мн'}], ['скала', {'дат,мн'}]]
мокрых накидках	[['мокрый', {'род,мн', 'вин,мн', 'пр,мн'}], ['накидка', {'пр,мн'}]]
мокрой тряпочкой	[['мокрый', {'дат,ед', 'твор,ед', 'род,ед', 'пр,ед'}], ['тряпочка', {'твор,ед'}]]
мокрую тряпочку	[['мокрый', {'вин,ед'}], ['тряпочка', {'вин,ед'}]]
мокром помоле	[['мокрый', {'пр,ед'}], ['помол', {'пр,ед'}]]
мокрого песка	[['мокрый', {'вин,ед', 'род,ед'}], ['песок', {'род,ед'}]]
мокрый окурок	[['мокрый', {'вин,ед', 'им,ед'}], ['окурок', {'вин,ед', 'им,ед'}]]
мокрая одежда	[['мокрый', {'им,ед'}], ['одежда', {'им,ед'}]]
мокрая стена	[['мокрый', {'им,ед'}], ['стена', {'род,ед', 'им,ед'}]]
мокром скруббере	[['мокрый', {'пр,ед'}], ['скруббер', {'пр,ед'}]]
мокрого тела	[['мокрый', {'вин,ед', 'род,ед'}], ['тело', {'вин,мн', 'род,ед', 'им,мн'}]]
мокрый лог	[['мокрый', {'вин,ед', 'им,ед'}], ['лог', {'вин,ед', 'им,ед'}]]
мокрый отпечаток	[['мокрый', {'вин,ед', 'им,ед'}], ['отпечаток', {'вин,ед', 'им,ед'}]]
мокрой кожи	[['мокрый', {'дат,ед', 'твор,ед', 'род,ед', 'пр,ед'}], ['кожа', {'вин,мн', 'род,ед', 'им,мн'}]]
мокрые усы	[['мокрый', {'вин,мн', 'им,мн'}], ['ус', {'вин,мн', 'им,мн', 'род,ед'}]]
мокрые фотографии	[['мокрый', {'вин,мн', 'им,мн'}], ['фотография', {'дат,ед', 'вин,мн', 'род,ед', 'им,мн', 'пр,ед'}]]
мокрый теленок	[['мокрый', {'вин,ед', 'им,ед'}], ['теленок', {'им,ед'}]]
мокрым листом	[['мокрый', {'твор,ед', 'дат,мн'}], ['лист', {'твор,ед'}]]
мокрые полосы	[['мокрый', {'вин,мн', 'им,мн'}], ['полоса', {'вин,мн', 'род,ед', 'им,мн'}]]
мокрых тел	[['мокрый', {'род,мн', 'вин,мн', 'пр,мн'}], ['тело', {'род,мн'}]]
мокрых портках	[['мокрый', {'род,мн', 'вин,мн', 'пр,мн'}], ['портки', {'пр,мн'}]]
мокрый трос	[['мокрый', {'вин,ед', 'им,ед'}], ['трос', {'вин,ед', 'им,ед'}]]
мокрые прутья	[['мокрый', {'вин,мн', 'им,мн'}], ['прут', {'вин,мн', 'им,мн'}]]
мокрых пятнах	[['мокрый', {'род,мн', 'вин,мн', 'пр,мн'}], ['пятно', {'пр,мн'}]]
мокрого дробления	[['мокрый', {'вин,ед', 'род,ед'}], ['дробление', {'вин,мн', 'род,ед', 'им,мн'}]]
мокрой мордой	[['мокрый', {'дат,ед', 'твор,ед', 'род,ед', 'пр,ед'}], ['морда', {'твор,ед'}]]
мокрая тряпица	[['мокрый', {'им,ед'}], ['тряпица', {'им,ед'}]]
мокрым стенам	[['мокрый', {'твор,ед', 'дат,мн'}], ['стена', {'дат,мн'}]]
мокрые леса	[['мокрый', {'вин,мн', 'им,мн'}], ['лес', {'вин,мн', 'род,ед', 'им,мн', 'им,ед'}]]
мокрую соль	[['мокрый', {'вин,ед'}], ['соль', {'род,ед', 'пр,ед', 'род,мн', 'твор,ед', 'вин,мн', 'им,мн', 'дат,мн', 'им,ед', 'твор,мн', 'вин,ед', 'пр,мн', 'дат,ед'}]]
мокрые вихры	[['мокрый', {'вин,мн', 'им,мн'}], ['вихор', {'вин,мн', 'им,мн'}]]
мокрой собаки	[['мокрый', {'дат,ед', 'твор,ед', 'род,ед', 'пр,ед'}], ['собака', {'род,ед', 'им,мн'}]]
мокрых болотах	[['мокрый', {'род,мн', 'вин,мн', 'пр,мн'}], ['болото', {'пр,мн'}]]
мокрыми травами	[['мокрый', {'твор,мн'}], ['трава', {'твор,мн'}]]
мокрый холст	[['мокрый', {'вин,ед', 'им,ед'}], ['холст', {'вин,ед', 'им,ед'}]]
мокрого рассвета	[['мокрый', {'вин,ед', 'род,ед'}], ['рассвет', {'род,ед'}]]
мокрой скамейке	[['мокрый', {'дат,ед', 'твор,ед', 'род,ед', 'пр,ед'}], ['скамейка', {'дат,ед', 'пр,ед'}]]
мокрые завитки	[['мокрый', {'вин,мн', 'им,мн'}], ['завиток', {'вин,мн', 'им,мн'}]]
мокрый канат	[['мокрый', {'вин,ед', 'им,ед'}], ['канат', {'вин,ед', 'им,ед'}]]
мокрой прядью	[['мокрый', {'дат,ед', 'твор,ед', 'род,ед', 'пр,ед'}], ['прядь', {'твор,ед'}]]
мокрой землею	[['мокрый', {'дат,ед', 'твор,ед', 'род,ед', 'пр,ед'}], ['земля', {'твор,ед'}]]
мокрый компресс	[['мокрый', {'вин,ед', 'им,ед'}], ['компресс', {'вин,ед', 'им,ед'}]]
мокрую кору	[['мокрый', {'вин,ед'}], ['кора', {'вин,ед'}]]
мокрыми губами	[['мокрый', {'твор,мн'}], ['губа', {'твор,мн'}]]
мокрый кирпич	[['мокрый', {'вин,ед', 'им,ед'}], ['кирпич', {'вин,ед', 'им,ед'}]]
мокрого катализа	[['мокрый', {'вин,ед', 'род,ед'}], ['катализ', {'род,ед'}]]
мокрые травы	[['мокрый', {'вин,мн', 'им,мн'}], ['трава', {'вин,мн', 'род,ед', 'им,мн'}]]
мокрую ветку	[['мокрый', {'вин,ед'}], ['ветка', {'вин,ед'}]]
мокрыми комьями	[['мокрый', {'твор,мн'}], ['ком', {'твор,мн'}]]
мокрого цыпленка	[['мокрый', {'вин,ед', 'род,ед'}], ['цыпленок', {'вин,ед', 'род,ед'}]]
мокрые сети	[['мокрый', {'вин,мн', 'им,мн'}], ['сеть', {'дат,ед', 'вин,мн', 'род,ед', 'им,мн', 'пр,ед'}]]
мокрыя руки	[['мокрый', {'устар,вин', 'устар,им'}], ['рука', {'вин,мн', 'род,ед', 'им,мн'}]]
мокрые голуби	[['мокрый', {'вин,мн', 'им,мн'}], ['голубь', {'им,мн'}]]
мокрые спины	[['мокрый', {'вин,мн', 'им,мн'}], ['спина', {'вин,мн', 'род,ед', 'им,мн'}]]
мокрой обработке	[['мокрый', {'дат,ед', 'твор,ед', 'род,ед', 'пр,ед'}], ['обработка', {'дат,ед', 'пр,ед'}]]
мокрым камнем	[['мокрый', {'твор,ед', 'дат,мн'}], ['камень', {'твор,ед'}]]
мокрая земля	[['мокрый', {'им,ед'}], ['земля', {'им,ед'}]]
мокрую полоску	[['мокрый', {'вин,ед'}], ['полоска', {'вин,ед'}]]
мокрой парусины	[['мокрый', {'дат,ед', 'твор,ед', 'род,ед', 'пр,ед'}], ['парусина', {'вин,мн', 'род,ед', 'им,мн'}]]
мокрыми пальцами	[['мокрый', {'твор,мн'}], ['палец', {'твор,мн'}]]
мокрый плетень	[['мокрый', {'вин,ед', 'им,ед'}], ['плетень', {'вин,ед', 'им,ед'}]]
мокрый зад	[['мокрый', {'вин,ед', 'им,ед'}], ['зад', {'вин,ед', 'им,ед'}]]
мокрой тундры	[['мокрый', {'дат,ед', 'твор,ед', 'род,ед', 'пр,ед'}], ['тундра', {'вин,мн', 'род,ед', 'им,мн'}]]
мокром ветру	[['мокрый', {'пр,ед'}], ['ветер', {'местн,ед', 'дат,ед'}]]
мокрый комок	[['мокрый', {'вин,ед', 'им,ед'}], ['комок', {'вин,ед', 'им,ед'}]]
мокрой щеки	[['мокрый', {'дат,ед', 'твор,ед', 'род,ед', 'пр,ед'}], ['щека', {'вин,мн', 'род,ед', 'им,мн'}]]
мокрая платформа	[['мокрый', {'им,ед'}], ['платформа', {'им,ед'}]]
мокрую листву	[['мокрый', {'вин,ед'}], ['листва', {'вин,ед'}]]
мокрый фильтр	[['мокрый', {'вин,ед', 'им,ед'}], ['фильтр', {'вин,ед', 'им,ед'}]]
мокрой ногой	[['мокрый', {'дат,ед', 'твор,ед', 'род,ед', 'пр,ед'}], ['нога', {'твор,ед'}]]
мокрого веника	[['мокрый', {'вин,ед', 'род,ед'}], ['веник', {'род,ед'}]]
мокрую тропу	[['мокрый', {'вин,ед'}], ['тропа', {'вин,ед', 'дат,ед'}]]
мокрой мгле	[['мокрый', {'дат,ед', 'твор,ед', 'род,ед', 'пр,ед'}], ['мгла', {'дат,ед', 'пр,ед'}]]
мокрого тельца	[['мокрый', {'вин,ед', 'род,ед'}], ['тельце', {'вин,ед', 'вин,мн', 'род,ед', 'им,мн'}]]
мокрым окном	[['мокрый', {'твор,ед', 'дат,мн'}], ['окно', {'твор,ед'}]]
мокрая щека	[['мокрый', {'им,ед'}], ['щека', {'им,ед'}]]
мокрый рот	[['мокрый', {'вин,ед', 'им,ед'}], ['рот', {'вин,ед', 'род,мн', 'им,ед'}]]
мокрой степи	[['мокрый', {'дат,ед', 'твор,ед', 'род,ед', 'пр,ед'}], ['степь', {'дат,ед', 'вин,мн', 'род,ед', 'им,мн', 'пр,ед'}]]
мокрой юбки	[['мокрый', {'дат,ед', 'твор,ед', 'род,ед', 'пр,ед'}], ['юбка', {'вин,мн', 'род,ед', 'им,мн'}]]
мокрые газеты	[['мокрый', {'вин,мн', 'им,мн'}], ['газета', {'вин,мн', 'род,ед', 'им,мн'}]]
мокрых плащах	[['мокрый', {'род,мн', 'вин,мн', 'пр,мн'}], ['плащ', {'пр,мн'}]]
мокрые головы	[['мокрый', {'вин,мн', 'им,мн'}], ['голова', {'вин,мн', 'род,ед', 'им,мн'}]]
мокра гвоздика	[['мокрый', {'ед,кр'}], ['гвоздика', {'род,ед', 'им,ед'}]]
мокрый берег	[['мокрый', {'вин,ед', 'им,ед'}], ['берег', {'вин,ед', 'прош,ед,изъяв,муж', 'им,ед'}]]
мокрую галку	[['мокрый', {'вин,ед'}], ['галка', {'вин,ед', 'дат,ед'}]]
мокрой кистью	[['мокрый', {'дат,ед', 'твор,ед', 'род,ед', 'пр,ед'}], ['кисть', {'твор,ед'}]]
мокрыми носками	[['мокрый', {'твор,мн'}], ['носок', {'твор,мн'}]]
мокрые скалы	[['мокрый', {'вин,мн', 'им,мн'}], ['скала', {'вин,мн', 'род,ед', 'им,мн'}]]
мокрому откосу	[['мокрый', {'дат,ед'}], ['откос', {'дат,ед'}]]
мокрее воды	[['мокрый', {'срав'}], ['вода', {'вин,мн', 'род,ед', 'им,мн'}]]
мокрую фуражку	[['мокрый', {'вин,ед'}], ['фуражка', {'вин,ед'}]]
мокрых бревнах	[['мокрый', {'род,мн', 'вин,мн', 'пр,мн'}], ['бревно', {'пр,мн'}]]
мокрых трусах	[['мокрый', {'род,мн', 'вин,мн', 'пр,мн'}], ['трусы', {'пр,мн'}]]
мокрый двор	[['мокрый', {'вин,ед', 'им,ед'}], ['двор', {'вин,ед', 'им,ед'}]]
мокрую весну	[['мокрый', {'вин,ед'}], ['весна', {'вин,ед'}]]
мокрую рубаху	[['мокрый', {'вин,ед'}], ['рубаха', {'вин,ед'}]]
мокрых мест	[['мокрый', {'род,мн', 'вин,мн', 'пр,мн'}], ['место', {'род,мн'}]]
мокрого кустарника	[['мокрый', {'вин,ед', 'род,ед'}], ['кустарник', {'род,ед'}]]
мокрую шляпу	[['мокрый', {'вин,ед'}], ['шляпа', {'вин,ед'}]]
мокрого тротуара	[['мокрый', {'вин,ед', 'род,ед'}], ['тротуар', {'род,ед'}]]
мокраго снега	[['мокрый', {'устар,вин', 'устар,род'}], ['снег', {'вин,мн', 'род,ед', 'им,мн'}]]
мокрого обогащения	[['мокрый', {'вин,ед', 'род,ед'}], ['обогащение', {'вин,мн', 'род,ед', 'им,мн'}]]
мокрая огорожа	[['мокрый', {'им,ед'}], ['огорожа', {'им,ед'}]]
мокрую палатку	[['мокрый', {'вин,ед'}], ['палатка', {'вин,ед'}]]
мокрое сжигание	[['мокрый', {'вин,ед', 'им,ед'}], ['сжигание', {'вин,ед', 'им,ед'}]]
мокрые борта	[['мокрый', {'вин,мн', 'им,мн'}], ['борт', {'вин,мн', 'род,ед', 'им,мн'}]]
мокромъ месте	[['мокрый', {'пр,ед'}], ['место', {'пр,ед'}]]
мокрый чай	[['мокрый', {'вин,ед', 'им,ед'}], ['чай', {'вин,ед', '', 'ед,пов,2-л', 'им,ед'}]]
мокрый кустарник	[['мокрый', {'вин,ед', 'им,ед'}], ['кустарник', {'вин,ед', 'им,ед'}]]
мокрой ложкой	[['мокрый', {'дат,ед', 'твор,ед', 'род,ед', 'пр,ед'}], ['ложка', {'твор,ед'}]]
мокрой коры	[['мокрый', {'дат,ед', 'твор,ед', 'род,ед', 'пр,ед'}], ['кора', {'род,ед'}]]
мокрых краев	[['мокрый', {'род,мн', 'вин,мн', 'пр,мн'}], ['край', {'род,мн', 'им,ед'}]]
мокрые бумажки	[['мокрый', {'вин,мн', 'им,мн'}], ['бумажка', {'вин,мн', 'род,ед', 'им,мн'}]]
мокрая паутина	[['мокрый', {'им,ед'}], ['паутина', {'им,ед'}]]
мокрый человек	[['мокрый', {'вин,ед', 'им,ед'}], ['человек', {'род,мн', 'вин,мн', 'им,ед'}]]
мокрых досках	[['мокрый', {'род,мн', 'вин,мн', 'пр,мн'}], ['доска', {'пр,мн'}]]
мокрая обработка	[['мокрый', {'им,ед'}], ['обработка', {'им,ед'}]]
мокрыми бровями	[['мокрый', {'твор,мн'}], ['бровь', {'твор,мн'}]]
мокрой лозы	[['мокрый', {'дат,ед', 'твор,ед', 'род,ед', 'пр,ед'}], ['лоза', {'вин,мн', 'род,ед', 'им,мн'}]]
мокрым канатом	[['мокрый', {'твор,ед', 'дат,мн'}], ['канат', {'твор,ед'}]]
мокрой дороге	[['мокрый', {'дат,ед', 'твор,ед', 'род,ед', 'пр,ед'}], ['дорога', {'дат,ед', 'пр,ед'}]]
мокрому городу	[['мокрый', {'дат,ед'}], ['город', {'дат,ед'}]]
мокрую щеку	[['мокрый', {'вин,ед'}], ['щека', {'вин,ед'}]]
мокрыми усами	[['мокрый', {'твор,мн'}], ['ус', {'твор,мн'}]]
мокрым плечам	[['мокрый', {'твор,ед', 'дат,мн'}], ['плечо', {'дат,мн'}]]
мокрым способом	[['мокрый', {'твор,ед', 'дат,мн'}], ['способ', {'твор,ед'}]]
мокрым соусом	[['мокрый', {'твор,ед', 'дат,мн'}], ['соус', {'твор,ед'}]]
мокрая шинель	[['мокрый', {'им,ед'}], ['шинель', {'вин,ед', 'им,ед'}]]
мокром отражении	[['мокрый', {'пр,ед'}], ['отражение', {'пр,ед'}]]
мокрую улицу	[['мокрый', {'вин,ед'}], ['улица', {'вин,ед'}]]
мокрому трапу	[['мокрый', {'дат,ед'}], ['трап', {'дат,ед'}]]
мокрое лицо	[['мокрый', {'вин,ед', 'им,ед'}], ['лицо', {'вин,ед', 'им,ед'}]]
мокрую клеенку	[['мокрый', {'вин,ед'}], ['клеенка', {'вин,ед'}]]
мокрых полей	[['мокрый', {'род,мн', 'вин,мн', 'пр,мн'}], ['поле', {'род,мн', 'срав', 'твор,ед', 'ед,пов,2-л,сов', 'вин,мн'}]]
мокрого снега	[['мокрый', {'вин,ед', 'род,ед'}], ['снег', {'вин,мн', 'род,ед', 'им,мн'}]]
мокрыми хлопьями	[['мокрый', {'твор,мн'}], ['хлопья', {'твор,мн'}]]
мокрым плащом	[['мокрый', {'твор,ед', 'дат,мн'}], ['плащ', {'твор,ед'}]]
мокрую ладошку	[['мокрый', {'вин,ед'}], ['ладошка', {'вин,ед'}]]
мокрой рукавицей	[['мокрый', {'дат,ед', 'твор,ед', 'род,ед', 'пр,ед'}], ['рукавица', {'твор,ед'}]]
мокрой шерстке	[['мокрый', {'дат,ед', 'твор,ед', 'род,ед', 'пр,ед'}], ['шерстка', {'дат,ед', 'пр,ед'}]]
мокрым платочком	[['мокрый', {'твор,ед', 'дат,мн'}], ['платочек', {'твор,ед'}]]
мокрую вату	[['мокрый', {'вин,ед'}], ['вата', {'вин,ед', 'дат,ед'}]]
мокрому полю	[['мокрый', {'дат,ед'}], ['поле', {'вин,ед', 'непрош,ед,изъяв,1-л', 'дат,ед'}]]
мокрыми одеялами	[['мокрый', {'твор,мн'}], ['одеяло', {'твор,мн'}]]
мокрого берега	[['мокрый', {'вин,ед', 'род,ед'}], ['берег', {'вин,мн', 'род,ед', 'им,мн'}]]
мокрой пленкой	[['мокрый', {'дат,ед', 'твор,ед', 'род,ед', 'пр,ед'}], ['пленка', {'твор,ед'}]]
мокрым лицом	[['мокрый', {'твор,ед', 'дат,мн'}], ['лицо', {'твор,ед'}]]
мокрые кудри	[['мокрый', {'вин,мн', 'им,мн'}], ['кудри', {'вин,мн', 'им,мн'}]]
мокрую грудь	[['мокрый', {'вин,ед'}], ['грудь', {'вин,ед', 'им,ед'}]]
мокрые носки	[['мокрый', {'вин,мн', 'им,мн'}], ['носок', {'им,ед,полн,сред', 'мн,кр', 'вин,мн', 'им,мн', 'род,ед'}]]
мокрый локоть	[['мокрый', {'вин,ед', 'им,ед'}], ['локоть', {'вин,ед', 'им,ед'}]]
мокрою землей	[['мокрый', {'твор,ед'}], ['земля', {'твор,ед'}]]
мокрого полотна	[['мокрый', {'вин,ед', 'род,ед'}], ['полотно', {'вин,мн', 'род,ед', 'им,мн'}]]
мокрых поленьев	[['мокрый', {'род,мн', 'вин,мн', 'пр,мн'}], ['полено', {'род,мн'}]]
мокрых хлопьев	[['мокрый', {'род,мн', 'вин,мн', 'пр,мн'}], ['хлопья', {'род,мн'}]]
мокрому носу	[['мокрый', {'дат,ед'}], ['нос', {'парт,ед', 'местн,ед', 'дат,ед'}]]
мокрым солончакам	[['мокрый', {'твор,ед', 'дат,мн'}], ['солончак', {'дат,мн'}]]
мокрое небо	[['мокрый', {'вин,ед', 'им,ед'}], ['небо', {'вин,ед', 'им,ед'}]]
мокрой крыши	[['мокрый', {'дат,ед', 'твор,ед', 'род,ед', 'пр,ед'}], ['крыша', {'вин,мн', 'род,ед', 'им,мн'}]]
мокрых скамеек	[['мокрый', {'род,мн', 'вин,мн', 'пр,мн'}], ['скамейка', {'род,мн'}]]
мокрый след	[['мокрый', {'вин,ед', 'им,ед'}], ['след', {'вин,ед', '', 'им,ед'}]]
мокром перроне	[['мокрый', {'пр,ед'}], ['перрон', {'пр,ед'}]]
мокрыми кустами	[['мокрый', {'твор,мн'}], ['куст', {'твор,мн'}]]
мокрых палатках	[['мокрый', {'род,мн', 'вин,мн', 'пр,мн'}], ['палатка', {'пр,мн'}]]
мокрую фигуру	[['мокрый', {'вин,ед'}], ['фигура', {'вин,ед'}]]
мокрого брезента	[['мокрый', {'вин,ед', 'род,ед'}], ['брезент', {'род,ед'}]]
мокрые поршни	[['мокрый', {'вин,мн', 'им,мн'}], ['поршень', {'вин,мн', 'им,мн'}]]
мокрую хвою	[['мокрый', {'вин,ед'}], ['хвоя', {'вин,ед', 'твор,ед', 'непрош,ед,изъяв,1-л'}]]
мокрого шоссе	[['мокрый', {'вин,ед', 'род,ед'}], ['шоссе', {'род,ед', 'пр,ед', 'род,мн', 'твор,ед', 'вин,мн', 'им,мн', 'дат,мн', 'им,ед', 'твор,мн', 'вин,ед', 'пр,мн', 'дат,ед'}]]
мокрые пряди	[['мокрый', {'вин,мн', 'им,мн'}], ['прядь', {'ед,пов,2-л,пе', 'род,ед', 'пр,ед', 'вин,мн', 'им,мн', 'дат,ед'}]]
мокрый хворост	[['мокрый', {'вин,ед', 'им,ед'}], ['хворост', {'вин,ед', 'им,ед'}]]
мокрым углом	[['мокрый', {'твор,ед', 'дат,мн'}], ['угол', {'твор,ед'}]]
мокрым полотном	[['мокрый', {'твор,ед', 'дат,мн'}], ['полотно', {'твор,ед'}]]
мокрые поля	[['мокрый', {'вин,мн', 'им,мн'}], ['поле', {'род,ед', 'непрош,деепр', 'вин,мн', 'им,мн', 'им,ед', 'вин,ед'}]]
мокрого мола	[['мокрый', {'вин,ед', 'род,ед'}], ['мол', {'род,ед'}]]
мокрый стол	[['мокрый', {'вин,ед', 'им,ед'}], ['стол', {'вин,ед', 'им,ед'}]]
мокрая палуба	[['мокрый', {'им,ед'}], ['палуба', {'им,ед'}]]
мокрое тело	[['мокрый', {'вин,ед', 'им,ед'}], ['тело', {'вин,ед', 'им,ед'}]]
мокрой шкурой	[['мокрый', {'дат,ед', 'твор,ед', 'род,ед', 'пр,ед'}], ['шкура', {'твор,ед'}]]
мокрую кепку	[['мокрый', {'вин,ед'}], ['кепка', {'вин,ед'}]]
мокрых цехах	[['мокрый', {'род,мн', 'вин,мн', 'пр,мн'}], ['цех', {'пр,мн'}]]
мокрого мха	[['мокрый', {'вин,ед', 'род,ед'}], ['мох', {'род,ед'}]]
мокрую одежду	[['мокрый', {'вин,ед'}], ['одежда', {'вин,ед'}]]
мокрой рукой	[['мокрый', {'дат,ед', 'твор,ед', 'род,ед', 'пр,ед'}], ['рука', {'твор,ед'}]]
мокрых способах	[['мокрый', {'род,мн', 'вин,мн', 'пр,мн'}], ['способ', {'пр,мн'}]]
мокрый блеск	[['мокрый', {'вин,ед', 'им,ед'}], ['блеск', {'вин,ед', 'им,ед'}]]
мокрый снегопад	[['мокрый', {'вин,ед', 'им,ед'}], ['снегопад', {'вин,ед', 'им,ед'}]]
мокрый прилавок	[['мокрый', {'вин,ед', 'им,ед'}], ['прилавок', {'вин,ед', 'им,ед'}]]
мокрые золоуловители	[['мокрый', {'вин,мн', 'им,мн'}], ['золоуловитель', {'вин,мн', 'им,мн'}]]
мокрые салфетки	[['мокрый', {'вин,мн', 'им,мн'}], ['салфетка', {'вин,мн', 'род,ед', 'им,мн'}]]
мокрого откоса	[['мокрый', {'вин,ед', 'род,ед'}], ['откос', {'род,ед'}]]
мокрому плащу	[['мокрый', {'дат,ед'}], ['плащ', {'дат,ед'}]]
мокрый лужок	[['мокрый', {'вин,ед', 'им,ед'}], ['лужок', {'вин,ед', 'им,ед'}]]
мокрых плащ	[['мокрый', {'род,мн', 'вин,мн', 'пр,мн'}], ['плащ', {'вин,ед', 'им,ед'}]]
мокрых грунтах	[['мокрый', {'род,мн', 'вин,мн', 'пр,мн'}], ['грунт', {'пр,мн'}]]
мокрые фигуры	[['мокрый', {'вин,мн', 'им,мн'}], ['фигура', {'вин,мн', 'род,ед', 'им,мн'}]]
мокрых глазах	[['мокрый', {'род,мн', 'вин,мн', 'пр,мн'}], ['глаз', {'пр,мн'}]]
мокрый забор	[['мокрый', {'вин,ед', 'им,ед'}], ['забор', {'вин,ед', 'им,ед'}]]
мокрые поцелуи	[['мокрый', {'вин,мн', 'им,мн'}], ['поцелуй', {'вин,мн', 'им,мн'}]]
мокрыми пряниками	[['мокрый', {'твор,мн'}], ['пряник', {'твор,мн'}]]
мокром бурении	[['мокрый', {'пр,ед'}], ['бурение', {'пр,ед'}]]
мокрой крапивой	[['мокрый', {'дат,ед', 'твор,ед', 'род,ед', 'пр,ед'}], ['крапива', {'твор,ед'}]]
мокрой рубашке	[['мокрый', {'дат,ед', 'твор,ед', 'род,ед', 'пр,ед'}], ['рубашка', {'дат,ед', 'пр,ед'}]]
мокрых газоочисток	[['мокрый', {'род,мн', 'вин,мн', 'пр,мн'}], ['газоочистка', {'род,мн'}]]
мокрое тряпье	[['мокрый', {'вин,ед', 'им,ед'}], ['тряпье', {'вин,ед', 'им,ед', 'пр,ед'}]]
мокрой почвы	[['мокрый', {'дат,ед', 'твор,ед', 'род,ед', 'пр,ед'}], ['почва', {'вин,мн', 'род,ед', 'им,мн'}]]
мокрые снопы	[['мокрый', {'вин,мн', 'им,мн'}], ['сноп', {'вин,мн', 'им,мн'}]]
мокрой веревочки	[['мокрый', {'дат,ед', 'твор,ед', 'род,ед', 'пр,ед'}], ['веревочка', {'вин,мн', 'род,ед', 'им,мн'}]]
мокрой полосе	[['мокрый', {'дат,ед', 'твор,ед', 'род,ед', 'пр,ед'}], ['полоса', {'дат,ед', 'пр,ед'}]]
мокрый свет	[['мокрый', {'вин,ед', 'им,ед'}], ['свет', {'вин,ед', 'род,мн', 'вин,мн', 'им,ед'}]]
мокрыми мешками	[['мокрый', {'твор,мн'}], ['мешок', {'твор,мн'}]]
мокрых ветках	[['мокрый', {'род,мн', 'вин,мн', 'пр,мн'}], ['ветка', {'пр,мн'}]]
мокрые башмаки	[['мокрый', {'вин,мн', 'им,мн'}], ['башмак', {'вин,мн', 'им,мн'}]]
мокрой сети	[['мокрый', {'дат,ед', 'твор,ед', 'род,ед', 'пр,ед'}], ['сеть', {'дат,ед', 'вин,мн', 'род,ед', 'им,мн', 'пр,ед'}]]
мокрый его	[['мокрый', {'вин,ед', 'им,ед'}], ['он=SPRO,ед,3-л,муж=вин', {'род,мн,сред', 'дат,мн', 'вин,ед,жен', 'дат,ед,жен', 'пр,мн,муж', 'твор,ед,сред', 'дат,мн,муж', 'род,ед,жен', 'им,мн,сред', 'твор,ед,муж', 'им,ед,сред', 'им,мн', 'род,ед,сред', 'твор,мн,сред', 'дат,ед,сред', 'вин,мн,муж', 'им,ед,муж', 'им,ед,жен', 'твор,ед,жен', 'пр,мн,сред', 'род,мн', 'вин,мн,од', 'пр,ед,жен', 'дат,ед,муж', 'вин,ед,сред', 'пр,ед,сред', 'пр,мн', 'вин,ед,муж,неод', 'вин,мн,сред', 'род,ед', 'род,ед,муж', 'вин,мн,неод', 'вин,ед,муж,од', 'твор,мн', 'дат,мн,сред', 'вин,ед,муж', 'пр,ед,муж', 'вин,ед'}]]
мокрому склону	[['мокрый', {'дат,ед'}], ['склон', {'дат,ед'}]]
мокрым тротуарам	[['мокрый', {'твор,ед', 'дат,мн'}], ['тротуар', {'дат,мн'}]]
мокрых золоуловителей	[['мокрый', {'род,мн', 'вин,мн', 'пр,мн'}], ['золоуловитель', {'род,мн'}]]
мокрых волос	[['мокрый', {'род,мн', 'вин,мн', 'пр,мн'}], ['волос', {'вин,ед', 'род,мн', 'им,ед'}]]
мокрые снимки	[['мокрый', {'вин,мн', 'им,мн'}], ['снимок', {'вин,мн', 'им,мн', 'род,ед'}]]
мокрые портки	[['мокрый', {'вин,мн', 'им,мн'}], ['портки', {'вин,мн', 'им,мн'}]]
мокрые процессы	[['мокрый', {'вин,мн', 'им,мн'}], ['процесс', {'вин,мн', 'им,мн'}]]
мокрых комьев	[['мокрый', {'род,мн', 'вин,мн', 'пр,мн'}], ['ком', {'род,мн'}]]
мокрою губкою	[['мокрый', {'твор,ед'}], ['губка', {'твор,ед'}]]
мокром лугу	[['мокрый', {'пр,ед'}], ['луг', {'вин,ед', 'местн,ед', 'дат,ед'}]]
мокрыми лбами	[['мокрый', {'твор,мн'}], ['лоб', {'твор,мн'}]]
мокрой скамье	[['мокрый', {'дат,ед', 'твор,ед', 'род,ед', 'пр,ед'}], ['скамья', {'дат,ед', 'пр,ед'}]]
мокрый рассев	[['мокрый', {'вин,ед', 'им,ед'}], ['рассев', {'вин,ед', 'им,ед'}]]
мокрым глазам	[['мокрый', {'твор,ед', 'дат,мн'}], ['глаз', {'дат,мн'}]]
мокрую кожу	[['мокрый', {'вин,ед'}], ['кожа', {'вин,ед'}]]
мокрые бревна	[['мокрый', {'вин,мн', 'им,мн'}], ['бревно', {'вин,мн', 'род,ед', 'им,мн'}]]
мокрой погоды	[['мокрый', {'дат,ед', 'твор,ед', 'род,ед', 'пр,ед'}], ['погода', {'вин,мн', 'род,ед', 'им,мн'}]]
мокрые края	[['мокрый', {'вин,мн', 'им,мн'}], ['край', {'вин,мн', 'род,ед', 'им,мн'}]]
мокрые булыжники	[['мокрый', {'вин,мн', 'им,мн'}], ['булыжник', {'вин,мн', 'им,мн'}]]
мокрых берегах	[['мокрый', {'род,мн', 'вин,мн', 'пр,мн'}], ['берег', {'пр,мн'}]]
мокрой коре	[['мокрый', {'дат,ед', 'твор,ед', 'род,ед', 'пр,ед'}], ['кора', {'дат,ед', 'пр,ед'}]]
мокрым местом	[['мокрый', {'твор,ед', 'дат,мн'}], ['место', {'твор,ед'}]]
мокрым полем	[['мокрый', {'твор,ед', 'дат,мн'}], ['поле', {'твор,ед', 'непрош,мн,изъяв,1-л'}]]
мокрое окошко	[['мокрый', {'вин,ед', 'им,ед'}], ['окошко', {'вин,ед', 'им,ед'}]]
мокрую даль	[['мокрый', {'вин,ед'}], ['даль', {'род,ед', 'пр,ед', 'род,мн', 'твор,ед', 'вин,мн', 'им,мн', 'дат,мн', 'им,ед', 'твор,мн', 'вин,ед', 'пр,мн', 'дат,ед'}]]
мокрую робу	[['мокрый', {'вин,ед'}], ['роба', {'вин,ед', 'дат,ед'}]]
мокрого полотенца	[['мокрый', {'вин,ед', 'род,ед'}], ['полотенце', {'вин,мн', 'род,ед', 'им,мн'}]]
мокрой крыше	[['мокрый', {'дат,ед', 'твор,ед', 'род,ед', 'пр,ед'}], ['крыша', {'дат,ед', 'пр,ед'}]]
мокрый жгут	[['мокрый', {'вин,ед', 'им,ед'}], ['жечь=V,несов,пе=непрош,мн,изъяв,3-л', {'вин,ед', 'непрош,мн,изъяв,3-л', 'им,ед'}]]
мокрые окурки	[['мокрый', {'вин,мн', 'им,мн'}], ['окурок', {'вин,мн', 'им,мн'}]]
мокрою пылью	[['мокрый', {'твор,ед'}], ['пыль', {'твор,ед'}]]
мокрый он	[['мокрый', {'вин,ед', 'им,ед'}], ['он=SPRO,ед,3-л,муж=им', {'им,ед'}]]
мокрых фильтров	[['мокрый', {'род,мн', 'вин,мн', 'пр,мн'}], ['фильтр', {'род,мн', 'ед,кр,муж'}]]
мокрому болоту	[['мокрый', {'дат,ед'}], ['болото', {'дат,ед'}]]
мокрого солончака	[['мокрый', {'вин,ед', 'род,ед'}], ['солончак', {'род,ед'}]]
мокрые снегопады	[['мокрый', {'вин,мн', 'им,мн'}], ['снегопад', {'вин,мн', 'им,мн'}]]
мокрыми сетями	[['мокрый', {'твор,мн'}], ['сеть', {'твор,мн'}]]
мокрый щебень	[['мокрый', {'вин,ед', 'им,ед'}], ['щебень', {'вин,ед', 'им,ед'}]]
мокрой клеенке	[['мокрый', {'дат,ед', 'твор,ед', 'род,ед', 'пр,ед'}], ['клеенка', {'дат,ед', 'пр,ед'}]]
мокрым боком	[['мокрый', {'твор,ед', 'дат,мн'}], ['бок', {'', 'твор,ед'}]]
мокрых лаптей	[['мокрый', {'род,мн', 'вин,мн', 'пр,мн'}], ['лапоть', {'род,мн', 'вин,мн'}]]
мокрыми крыльями	[['мокрый', {'твор,мн'}], ['крыло', {'твор,мн'}]]
мокрой улице	[['мокрый', {'дат,ед', 'твор,ед', 'род,ед', 'пр,ед'}], ['улица', {'дат,ед', 'пр,ед'}]]
мокрым снегом	[['мокрый', {'твор,ед', 'дат,мн'}], ['снег', {'твор,ед'}]]
мокрую площадь	[['мокрый', {'вин,ед'}], ['площадь', {'вин,ед', 'им,ед'}]]
мокрый сарафан	[['мокрый', {'вин,ед', 'им,ед'}], ['сарафан', {'вин,ед', 'им,ед'}]]
мокрой мелочью	[['мокрый', {'дат,ед', 'твор,ед', 'род,ед', 'пр,ед'}], ['мелочь', {'твор,ед'}]]
мокрых пальцев	[['мокрый', {'род,мн', 'вин,мн', 'пр,мн'}], ['палец', {'род,мн', 'им,ед'}]]
мокрого осаждения	[['мокрый', {'вин,ед', 'род,ед'}], ['осаждение', {'вин,мн', 'род,ед', 'им,мн'}]]
мокрых стаканов	[['мокрый', {'род,мн', 'вин,мн', 'пр,мн'}], ['стакан', {'род,мн'}]]
мокрым стеклам	[['мокрый', {'твор,ед', 'дат,мн'}], ['стекло', {'дат,мн'}]]
мокрой шляпе	[['мокрый', {'дат,ед', 'твор,ед', 'род,ед', 'пр,ед'}], ['шляпа', {'дат,ед', 'пр,ед'}]]
мокрой лапой	[['мокрый', {'дат,ед', 'твор,ед', 'род,ед', 'пр,ед'}], ['лапа', {'твор,ед'}]]
мокрый снегъ	[['мокрый', {'вин,ед', 'им,ед'}], ['снег', {'вин,ед', 'им,ед'}]]
мокрой мглы	[['мокрый', {'дат,ед', 'твор,ед', 'род,ед', 'пр,ед'}], ['мгла', {'вин,мн', 'род,ед', 'им,мн'}]]
мокрые метели	[['мокрый', {'вин,мн', 'им,мн'}], ['метель', {'дат,ед', 'вин,мн', 'род,ед', 'им,мн', 'пр,ед'}]]
мокрую уборку	[['мокрый', {'вин,ед'}], ['уборка', {'вин,ед'}]]
мокрая поверхность	[['мокрый', {'им,ед'}], ['поверхность', {'вин,ед', 'им,ед'}]]
мокрых носков	[['мокрый', {'род,мн', 'вин,мн', 'пр,мн'}], ['носок', {'род,мн', 'им,ед'}]]
мокрое крыло	[['мокрый', {'вин,ед', 'им,ед'}], ['крыло', {'вин,ед', 'им,ед', 'прош,ед,изъяв,сред'}]]
мокрый бинт	[['мокрый', {'вин,ед', 'им,ед'}], ['бинт', {'вин,ед', 'им,ед'}]]
мокрые штанины	[['мокрый', {'вин,мн', 'им,мн'}], ['штанина', {'вин,мн', 'род,ед', 'им,мн'}]]
мокрому боку	[['мокрый', {'дат,ед'}], ['бок', {'местн,ед', 'дат,ед'}]]
мокрые зонтики	[['мокрый', {'вин,мн', 'им,мн'}], ['зонтик', {'вин,мн', 'им,мн'}]]
мокрых галках	[['мокрый', {'род,мн', 'вин,мн', 'пр,мн'}], ['галка', {'пр,мн'}]]
мокрую скамейку	[['мокрый', {'вин,ед'}], ['скамейка', {'вин,ед'}]]
мокрого сукна	[['мокрый', {'вин,ед', 'род,ед'}], ['сукно', {'вин,мн', 'род,ед', 'им,мн'}]]
мокрых башмаках	[['мокрый', {'род,мн', 'вин,мн', 'пр,мн'}], ['башмак', {'пр,мн'}]]
мокрой пеленой	[['мокрый', {'дат,ед', 'твор,ед', 'род,ед', 'пр,ед'}], ['пелена', {'твор,ед'}]]
мокрому следу	[['мокрый', {'дат,ед'}], ['след', {'местн,ед', 'дат,ед'}]]
мокром белье	[['мокрый', {'пр,ед'}], ['белье', {'вин,ед', 'им,ед', 'пр,ед'}]]
мокрый воротник	[['мокрый', {'вин,ед', 'им,ед'}], ['воротник', {'вин,ед', 'им,ед'}]]
мокрых лавин	[['мокрый', {'род,мн', 'вин,мн', 'пр,мн'}], ['лавина', {'род,ед', 'пр,ед', 'род,мн', 'твор,ед', 'вин,мн', 'им,мн', 'им,ед', 'дат,мн', 'твор,мн', 'вин,ед', 'пр,мн', 'дат,ед'}]]
мокрая крыша	[['мокрый', {'им,ед'}], ['крыша', {'им,ед'}]]
мокрые травинки	[['мокрый', {'вин,мн', 'им,мн'}], ['травинка', {'вин,мн', 'род,ед', 'им,мн'}]]
мокрых пылеуловителях	[['мокрый', {'род,мн', 'вин,мн', 'пр,мн'}], ['пылеуловитель', {'пр,мн'}]]
мокрых веток	[['мокрый', {'род,мн', 'вин,мн', 'пр,мн'}], ['ветка', {'род,мн'}]]
мокрую шерсть	[['мокрый', {'вин,ед'}], ['шерсть', {'вин,ед', 'им,ед'}]]
мокрым мостовым	[['мокрый', {'твор,ед', 'дат,мн'}], ['мостовая', {'твор,ед,сред', 'твор,ед,полн,муж', 'твор,ед,муж', 'твор,ед', 'дат,мн', 'дат,мн,полн', 'твор,ед,полн,сред'}]]
мокрых травах	[['мокрый', {'род,мн', 'вин,мн', 'пр,мн'}], ['трава', {'пр,мн'}]]
мокрыми водорослями	[['мокрый', {'твор,мн'}], ['водоросль', {'твор,мн'}]]
мокрые ступени	[['мокрый', {'вин,мн', 'им,мн'}], ['ступень', {'дат,ед', 'вин,мн', 'род,ед', 'им,мн', 'пр,ед'}]]
мокрую бумагу	[['мокрый', {'вин,ед'}], ['бумага', {'вин,ед'}]]
мокрой собакой	[['мокрый', {'дат,ед', 'твор,ед', 'род,ед', 'пр,ед'}], ['собака', {'твор,ед'}]]
мокрых ворон	[['мокрый', {'род,мн', 'вин,мн', 'пр,мн'}], ['ворон', {'род,мн', 'вин,мн', 'им,ед'}]]
мокрые хлопья	[['мокрый', {'вин,мн', 'им,мн'}], ['хлопья', {'вин,мн', 'им,мн'}]]
мокрая улица	[['мокрый', {'им,ед'}], ['улица', {'им,ед'}]]
мокрую очистку	[['мокрый', {'вин,ед'}], ['очистка', {'вин,ед'}]]
мокрая лента	[['мокрый', {'им,ед'}], ['лента', {'им,ед'}]]
мокрой стенке	[['мокрый', {'дат,ед', 'твор,ед', 'род,ед', 'пр,ед'}], ['стенка', {'дат,ед', 'пр,ед'}]]
мокрые дома	[['мокрый', {'вин,мн', 'им,мн'}], ['дом', {'', 'вин,мн', 'род,ед', 'им,мн'}]]
мокрый шнур	[['мокрый', {'вин,ед', 'им,ед'}], ['шнур', {'вин,ед', 'им,ед'}]]
мокрой земле	[['мокрый', {'дат,ед', 'твор,ед', 'род,ед', 'пр,ед'}], ['земля', {'дат,ед', 'пр,ед'}]]
мокрая трава	[['мокрый', {'им,ед'}], ['трава', {'им,ед'}]]
мокрого леса	[['мокрый', {'вин,ед', 'род,ед'}], ['лес', {'вин,мн', 'род,ед', 'им,мн', 'им,ед'}]]
мокрым песком	[['мокрый', {'твор,ед', 'дат,мн'}], ['песок', {'твор,ед'}]]
мокрым то	[['мокрый', {'твор,ед', 'дат,мн'}], ['то=SPRO,ед,сред,неод=вин', {'вин,ед', '', 'вин,ед,сред', 'им,ед,сред', 'им,ед'}]]
мокрою погодою	[['мокрый', {'твор,ед'}], ['погода', {'твор,ед'}]]
мокрая пурга	[['мокрый', {'им,ед'}], ['пурга', {'им,ед'}]]
мокрыми косицами	[['мокрый', {'твор,мн'}], ['косица', {'твор,мн'}]]
мокрых рукавах	[['мокрый', {'род,мн', 'вин,мн', 'пр,мн'}], ['рукав', {'пр,мн'}]]
мокрыми платками	[['мокрый', {'твор,мн'}], ['платок', {'твор,мн'}]]
мокрая гниль	[['мокрый', {'им,ед'}], ['гниль', {'вин,ед', 'им,ед'}]]
мокрую печать	[['мокрый', {'вин,ед'}], ['печать', {'вин,ед', 'им,ед'}]]
мокрого торфа	[['мокрый', {'вин,ед', 'род,ед'}], ['торф', {'вин,мн', 'род,ед', 'им,мн'}]]
мокрую солому	[['мокрый', {'вин,ед'}], ['солома', {'вин,ед'}]]
мокрые камни	[['мокрый', {'вин,мн', 'им,мн'}], ['камень', {'вин,мн', 'им,мн'}]]
мокрый день	[['мокрый', {'вин,ед', 'им,ед'}], ['день', {'вин,ед', 'ед,пов,2-л,сов', 'им,ед'}]]
мокрого прессования	[['мокрый', {'вин,ед', 'род,ед'}], ['прессование', {'вин,мн', 'род,ед', 'им,мн'}]]
мокрых дней	[['мокрый', {'род,мн', 'вин,мн', 'пр,мн'}], ['день', {'род,мн'}]]
мокрым кочкам	[['мокрый', {'твор,ед', 'дат,мн'}], ['кочка', {'дат,мн'}]]
мокрые валенки	[['мокрый', {'вин,мн', 'им,мн'}], ['валенок', {'вин,мн', 'им,мн'}]]
мокрую яму	[['мокрый', {'вин,ед'}], ['яма', {'вин,ед', 'дат,ед'}]]
мокрых центифолий	[['мокрый', {'род,мн', 'вин,мн', 'пр,мн'}], ['центифолия', {'род,мн'}]]
мокрый хруст	[['мокрый', {'вин,ед', 'им,ед'}], ['хруст', {'вин,ед', 'им,ед'}]]
мокрых дорогах	[['мокрый', {'род,мн', 'вин,мн', 'пр,мн'}], ['дорога', {'пр,мн'}]]
мокрых водорослей	[['мокрый', {'род,мн', 'вин,мн', 'пр,мн'}], ['водоросль', {'род,мн'}]]
мокрых канатов	[['мокрый', {'род,мн', 'вин,мн', 'пр,мн'}], ['канат', {'род,мн'}]]
мокрый хлеб	[['мокрый', {'вин,ед', 'им,ед'}], ['хлеб', {'вин,ед', 'им,ед'}]]
мокрые власы	[['мокрый', {'вин,мн', 'им,мн'}], ['власы', {'вин,мн', 'им,мн'}]]
мокрыми тряпочками	[['мокрый', {'твор,мн'}], ['тряпочка', {'твор,мн'}]]
мокрого куста	[['мокрый', {'вин,ед', 'род,ед'}], ['куст', {'род,ед'}]]
мокрый платок	[['мокрый', {'вин,ед', 'им,ед'}], ['платок', {'вин,ед', 'им,ед'}]]
мокрой полыни	[['мокрый', {'дат,ед', 'твор,ед', 'род,ед', 'пр,ед'}], ['полынь', {'дат,ед', 'вин,мн', 'род,ед', 'им,мн', 'пр,ед'}]]
мокрую стену	[['мокрый', {'вин,ед'}], ['стена', {'вин,ед', 'дат,ед'}]]
мокрыми боками	[['мокрый', {'твор,мн'}], ['бок', {'твор,мн'}]]
мокрая грязь	[['мокрый', {'им,ед'}], ['грязь', {'вин,ед', 'им,ед'}]]
мокрым садом	[['мокрый', {'твор,ед', 'дат,мн'}], ['сад', {'твор,ед'}]]
мокрой травъ	[['мокрый', {'дат,ед', 'твор,ед', 'род,ед', 'пр,ед'}], ['трава', {'род,мн'}]]
мокрой брусчатке	[['мокрый', {'дат,ед', 'твор,ед', 'род,ед', 'пр,ед'}], ['брусчатка', {'дат,ед', 'пр,ед'}]]
мокрый овраг	[['мокрый', {'вин,ед', 'им,ед'}], ['овраг', {'вин,ед', 'им,ед'}]]
мокрых ступенях	[['мокрый', {'род,мн', 'вин,мн', 'пр,мн'}], ['ступень', {'пр,мн'}]]
мокрый металл	[['мокрый', {'вин,ед', 'им,ед'}], ['металл', {'вин,ед', 'им,ед'}]]
мокрые туфли	[['мокрый', {'вин,мн', 'им,мн'}], ['туфля', {'вин,мн', 'род,ед', 'им,мн'}]]
мокрые вещи	[['мокрый', {'вин,мн', 'им,мн'}], ['вещь', {'мн,кр', 'род,ед', 'пр,ед', 'вин,мн', 'им,мн', 'дат,ед'}]]
мокрый рюкзак	[['мокрый', {'вин,ед', 'им,ед'}], ['рюкзак', {'вин,ед', 'им,ед'}]]
мокрые трусики	[['мокрый', {'вин,мн', 'им,мн'}], ['трусики', {'вин,мн', 'им,мн'}]]
мокрой ромашки	[['мокрый', {'дат,ед', 'твор,ед', 'род,ед', 'пр,ед'}], ['ромашка', {'вин,мн', 'род,ед', 'им,мн'}]]
мокрую гриву	[['мокрый', {'вин,ед'}], ['грива', {'вин,ед'}]]
мокрого пара	[['мокрый', {'вин,ед', 'род,ед'}], ['пара', {'род,ед', 'им,ед'}]]
мокрою землею	[['мокрый', {'твор,ед'}], ['земля', {'твор,ед'}]]
мокрая газоочистка	[['мокрый', {'им,ед'}], ['газоочистка', {'им,ед'}]]
мокрые волосы	[['мокрый', {'вин,мн', 'им,мн'}], ['волос', {'вин,мн', 'им,мн'}]]
мокрый запах	[['мокрый', {'вин,ед', 'им,ед'}], ['запах', {'вин,ед', 'прош,ед,изъяв,муж', 'им,ед'}]]
мокрый козырек	[['мокрый', {'вин,ед', 'им,ед'}], ['козырек', {'вин,ед', 'им,ед'}]]
мокрое месиво	[['мокрый', {'вин,ед', 'им,ед'}], ['месиво', {'вин,ед', 'им,ед'}]]
мокрые щепки	[['мокрый', {'вин,мн', 'им,мн'}], ['щепка', {'вин,мн', 'род,ед', 'им,мн'}]]
мокрых трусиках	[['мокрый', {'род,мн', 'вин,мн', 'пр,мн'}], ['трусики', {'пр,мн'}]]
мокрое пятно	[['мокрый', {'вин,ед', 'им,ед'}], ['пятно', {'вин,ед', 'им,ед'}]]
мокром граните	[['мокрый', {'пр,ед'}], ['гранит', {'дат,ед', 'мн,пов,2-л', 'непрош,мн,изъяв,2-л', 'пр,ед'}]]
мокрая рубаха	[['мокрый', {'им,ед'}], ['рубаха', {'им,ед'}]]
мокрых сетях	[['мокрый', {'род,мн', 'вин,мн', 'пр,мн'}], ['сеть', {'пр,мн'}]]
мокрое ведро	[['мокрый', {'вин,ед', 'им,ед'}], ['ведро', {'вин,ед', 'им,ед'}]]
мокрых дорожках	[['мокрый', {'род,мн', 'вин,мн', 'пр,мн'}], ['дорожка', {'пр,мн'}]]
мокрый город	[['мокрый', {'вин,ед', 'им,ед'}], ['город', {'вин,ед', 'им,ед'}]]
мокрыми ногами	[['мокрый', {'твор,мн'}], ['нога', {'твор,мн'}]]
мокрой работе	[['мокрый', {'дат,ед', 'твор,ед', 'род,ед', 'пр,ед'}], ['работа', {'дат,ед', 'пр,ед'}]]
мокрых лугах	[['мокрый', {'род,мн', 'вин,мн', 'пр,мн'}], ['луг', {'пр,мн'}]]
мокрая химия	[['мокрый', {'им,ед'}], ['химия', {'им,ед'}]]
мокрым лбом	[['мокрый', {'твор,ед', 'дат,мн'}], ['лоб', {'твор,ед'}]]
мокрого луга	[['мокрый', {'вин,ед', 'род,ед'}], ['луг', {'вин,мн', 'род,ед', 'им,мн', 'им,ед'}]]
мокрой классификации	[['мокрый', {'дат,ед', 'твор,ед', 'род,ед', 'пр,ед'}], ['классификация', {'дат,ед', 'вин,мн', 'род,ед', 'им,мн', 'пр,ед'}]]
мокрыми метлами	[['мокрый', {'твор,мн'}], ['метла', {'твор,мн'}]]
мокрые зонты	[['мокрый', {'вин,мн', 'им,мн'}], ['зонт', {'вин,мн', 'им,мн'}]]
мокрый откос	[['мокрый', {'вин,ед', 'им,ед'}], ['откос', {'вин,ед', 'им,ед'}]]
мокрых сучьев	[['мокрый', {'род,мн', 'вин,мн', 'пр,мн'}], ['сук', {'род,мн'}]]
мокрые валуны	[['мокрый', {'вин,мн', 'им,мн'}], ['валун', {'вин,мн', 'им,мн'}]]
мокрыми прутьями	[['мокрый', {'твор,мн'}], ['прут', {'твор,мн'}]]
мокрой галькой	[['мокрый', {'дат,ед', 'твор,ед', 'род,ед', 'пр,ед'}], ['галька', {'твор,ед'}]]
мокрые верхушки	[['мокрый', {'вин,мн', 'им,мн'}], ['верхушка', {'вин,мн', 'род,ед', 'им,мн'}]]
мокрой парусиной	[['мокрый', {'дат,ед', 'твор,ед', 'род,ед', 'пр,ед'}], ['парусина', {'твор,ед'}]]
мокрые плащи	[['мокрый', {'вин,мн', 'им,мн'}], ['плащ', {'вин,мн', 'им,мн'}]]
мокрого зонтика	[['мокрый', {'вин,ед', 'род,ед'}], ['зонтик', {'род,ед'}]]
мокрому озолению	[['мокрый', {'дат,ед'}], ['озоление', {'дат,ед'}]]
мокрые коленки	[['мокрый', {'вин,мн', 'им,мн'}], ['коленка', {'вин,мн', 'род,ед', 'им,мн'}]]
мокрые горы	[['мокрый', {'вин,мн', 'им,мн'}], ['гора', {'вин,мн', 'род,ед', 'им,мн'}]]
мокрые лавины	[['мокрый', {'вин,мн', 'им,мн'}], ['лавина', {'вин,мн', 'род,ед', 'им,мн'}]]
мокрому снегу	[['мокрый', {'дат,ед'}], ['снег', {'парт,ед', 'местн,ед', 'дат,ед'}]]
мокрые платформы	[['мокрый', {'вин,мн', 'им,мн'}], ['платформа', {'вин,мн', 'род,ед', 'им,мн'}]]
мокрого окошка	[['мокрый', {'вин,ед', 'род,ед'}], ['окошко', {'род,ед'}]]
мокрыми гильзами	[['мокрый', {'твор,мн'}], ['гильза', {'твор,мн'}]]
мокрое болото	[['мокрый', {'вин,ед', 'им,ед'}], ['болото', {'вин,ед', 'им,ед'}]]
мокрое зерно	[['мокрый', {'вин,ед', 'им,ед'}], ['зерно', {'вин,ед', 'им,ед'}]]
мокрые ленты	[['мокрый', {'вин,мн', 'им,мн'}], ['лента', {'вин,мн', 'род,ед', 'им,мн'}]]
мокрой простыни	[['мокрый', {'дат,ед', 'твор,ед', 'род,ед', 'пр,ед'}], ['простыня', {'вин,мн', 'род,ед', 'им,мн'}]]
мокрую пасть	[['мокрый', {'вин,ед'}], ['пасть', {'вин,ед', 'инф', 'им,ед'}]]
мокрых пнях	[['мокрый', {'род,мн', 'вин,мн', 'пр,мн'}], ['пень', {'пр,мн'}]]
мокрого грунта	[['мокрый', {'вин,ед', 'род,ед'}], ['грунт', {'род,ед'}]]
мокрому тротуару	[['мокрый', {'дат,ед'}], ['тротуар', {'дат,ед'}]]
мокрой химии	[['мокрый', {'дат,ед', 'твор,ед', 'род,ед', 'пр,ед'}], ['химия', {'дат,ед', 'вин,мн', 'род,ед', 'им,мн', 'пр,ед'}]]
мокрое измельчение	[['мокрый', {'вин,ед', 'им,ед'}], ['измельчение', {'вин,ед', 'им,ед'}]]
мокрым улицам	[['мокрый', {'твор,ед', 'дат,мн'}], ['улица', {'дат,мн'}]]
мокрую кофту	[['мокрый', {'вин,ед'}], ['кофта', {'вин,ед'}]]
мокрые портянки	[['мокрый', {'вин,мн', 'им,мн'}], ['портянка', {'вин,мн', 'род,ед', 'им,мн'}]]
мокрых чулках	[['мокрый', {'род,мн', 'вин,мн', 'пр,мн'}], ['чулок', {'пр,мн'}]]
мокрой дороги	[['мокрый', {'дат,ед', 'твор,ед', 'род,ед', 'пр,ед'}], ['дорога', {'мн,кр', 'вин,мн', 'род,ед', 'им,мн'}]]
мокрого размола	[['мокрый', {'вин,ед', 'род,ед'}], ['размол', {'род,ед'}]]
мокрые рубашки	[['мокрый', {'вин,мн', 'им,мн'}], ['рубашка', {'вин,мн', 'род,ед', 'им,мн'}]]
мокрые паруса	[['мокрый', {'вин,мн', 'им,мн'}], ['парус', {'вин,мн', 'род,ед', 'им,мн'}]]
мокрых трав	[['мокрый', {'род,мн', 'вин,мн', 'пр,мн'}], ['трава', {'род,мн'}]]
мокром тушении	[['мокрый', {'пр,ед'}], ['тушение', {'пр,ед'}]]
мокрые ветки	[['мокрый', {'вин,мн', 'им,мн'}], ['ветка', {'вин,мн', 'род,ед', 'им,мн'}]]
мокрый корень	[['мокрый', {'вин,ед', 'им,ед'}], ['корень', {'вин,ед', 'им,ед'}]]
мокрому гравию	[['мокрый', {'дат,ед'}], ['гравий', {'парт,ед', 'дат,ед'}]]
мокрую дорожку	[['мокрый', {'вин,ед'}], ['дорожка', {'вин,ед'}]]
мокрый чуб	[['мокрый', {'вин,ед', 'им,ед'}], ['чуб', {'род,ед', 'пр,ед', 'род,мн', 'твор,ед', 'вин,мн', 'им,мн', 'дат,мн', 'им,ед', 'твор,мн', 'вин,ед', 'пр,мн', 'дат,ед'}]]
мокрым языком	[['мокрый', {'твор,ед', 'дат,мн'}], ['язык', {'твор,ед'}]]
мокрому берегу	[['мокрый', {'дат,ед'}], ['берег', {'местн,ед', 'непрош,ед,изъяв,1-л', 'дат,ед'}]]
мокрые методы	[['мокрый', {'вин,мн', 'им,мн'}], ['метод', {'вин,мн', 'им,мн', 'род,ед'}]]
мокрыми полотенцами	[['мокрый', {'твор,мн'}], ['полотенце', {'твор,мн'}]]
мокрый борт	[['мокрый', {'вин,ед', 'им,ед'}], ['борт', {'вин,ед', 'им,ед'}]]
мокрого угла	[['мокрый', {'вин,ед', 'род,ед'}], ['угол', {'род,ед'}]]
мокрыми процессами	[['мокрый', {'твор,мн'}], ['процесс', {'твор,мн'}]]
мокрыми стеклами	[['мокрый', {'твор,мн'}], ['стекло', {'твор,мн'}]]
мокрым плитам	[['мокрый', {'твор,ед', 'дат,мн'}], ['плита', {'дат,мн'}]]
мокрой пади	[['мокрый', {'дат,ед', 'твор,ед', 'род,ед', 'пр,ед'}], ['падь', {'род,ед', 'пр,ед', 'ед,пов,2-л', 'вин,мн', 'им,мн', 'дат,ед'}]]
мокрый подол	[['мокрый', {'вин,ед', 'им,ед'}], ['подол', {'вин,ед', 'им,ед'}]]
мокрых гимнастерках	[['мокрый', {'род,мн', 'вин,мн', 'пр,мн'}], ['гимнастерка', {'пр,мн'}]]
мокрые шинели	[['мокрый', {'вин,мн', 'им,мн'}], ['шинель', {'дат,ед', 'вин,мн', 'род,ед', 'им,мн', 'пр,ед'}]]
мокрую марлю	[['мокрый', {'вин,ед'}], ['марля', {'вин,ед'}]]
мокрым лицам	[['мокрый', {'твор,ед', 'дат,мн'}], ['лицо', {'дат,мн'}]]
мокрая газета	[['мокрый', {'им,ед'}], ['газета', {'им,ед'}]]
мокрой драни	[['мокрый', {'дат,ед', 'твор,ед', 'род,ед', 'пр,ед'}], ['дрань', {'дат,ед', 'вин,мн', 'род,ед', 'им,мн', 'пр,ед'}]]
мокрая каша	[['мокрый', {'им,ед'}], ['каша', {'им,ед'}]]
мокрых шинелей	[['мокрый', {'род,мн', 'вин,мн', 'пр,мн'}], ['шинель', {'род,мн'}]]
мокрыми полями	[['мокрый', {'твор,мн'}], ['поле', {'твор,мн'}]]
мокрый сахар	[['мокрый', {'вин,ед', 'им,ед'}], ['сахар', {'вин,ед', 'род,мн', 'им,ед'}]]
мокрому льду	[['мокрый', {'дат,ед'}], ['лед', {'парт,ед', 'местн,ед', 'дат,ед'}]]
мокрая часть	[['мокрый', {'им,ед'}], ['часть', {'вин,ед', 'им,ед'}]]
мокрым делом	[['мокрый', {'твор,ед', 'дат,мн'}], ['дело', {'твор,ед'}]]
мокрый зонт	[['мокрый', {'вин,ед', 'им,ед'}], ['зонт', {'вин,ед', 'им,ед'}]]
мокрые колени	[['мокрый', {'вин,мн', 'им,мн'}], ['колено', {'вин,мн', 'им,мн'}]]
мокрую телогрейку	[['мокрый', {'вин,ед'}], ['телогрейка', {'вин,ед'}]]
мокрым полотенцем	[['мокрый', {'твор,ед', 'дат,мн'}], ['полотенце', {'твор,ед'}]]
мокрых шароварах	[['мокрый', {'род,мн', 'вин,мн', 'пр,мн'}], ['шаровары', {'пр,мн'}]]
мокрым местам	[['мокрый', {'твор,ед', 'дат,мн'}], ['место', {'дат,мн'}]]
мокрая сеть	[['мокрый', {'им,ед'}], ['сеть', {'вин,ед', 'им,ед'}]]
мокрую голову	[['мокрый', {'вин,ед'}], ['голова', {'вин,ед', 'дат,ед'}]]
мокрые шкуры	[['мокрый', {'вин,мн', 'им,мн'}], ['шкура', {'вин,мн', 'род,ед', 'им,мн'}]]
мокрых сапогах	[['мокрый', {'род,мн', 'вин,мн', 'пр,мн'}], ['сапог', {'пр,мн'}]]
мокрым глазом	[['мокрый', {'твор,ед', 'дат,мн'}], ['глаз', {'твор,ед'}]]
мокрая мышь	[['мокрый', {'им,ед'}], ['мышь', {'вин,ед', 'им,ед'}]]
мокрый ветер	[['мокрый', {'вин,ед', 'им,ед'}], ['ветер', {'вин,ед', 'им,ед'}]]
мокрой травы	[['мокрый', {'дат,ед', 'твор,ед', 'род,ед', 'пр,ед'}], ['трава', {'вин,мн', 'род,ед', 'им,мн'}]]
мокрый лоб	[['мокрый', {'вин,ед', 'им,ед'}], ['лоб', {'вин,ед', 'им,ед'}]]
мокрому сжиганию	[['мокрый', {'дат,ед'}], ['сжигание', {'дат,ед'}]]
мокрым доскам	[['мокрый', {'твор,ед', 'дат,мн'}], ['доска', {'дат,мн'}]]
мокром песке	[['мокрый', {'пр,ед'}], ['песок', {'пр,ед'}]]
мокрая она	[['мокрый', {'им,ед'}], ['она=SPRO,ед,3-л,жен=им', {'им,ед'}]]
мокрый подбородок	[['мокрый', {'вин,ед', 'им,ед'}], ['подбородок', {'вин,ед', 'им,ед'}]]
мокром поле	[['мокрый', {'пр,ед'}], ['поле', {'вин,ед', 'дат,ед', 'им,ед', 'пр,ед'}]]
мокрого бетона	[['мокрый', {'вин,ед', 'род,ед'}], ['бетон', {'род,ед'}]]
мокрою курицей	[['мокрый', {'твор,ед'}], ['курица', {'твор,ед'}]]
мокрые брови	[['мокрый', {'вин,мн', 'им,мн'}], ['бровь', {'дат,ед', 'вин,мн', 'род,ед', 'им,мн', 'пр,ед'}]]
мокром глянце	[['мокрый', {'пр,ед'}], ['глянец', {'пр,ед'}]]
мокрому листу	[['мокрый', {'дат,ед'}], ['лист', {'дат,ед'}]]
мокрую шкуру	[['мокрый', {'вин,ед'}], ['шкура', {'вин,ед'}]]
мокрую тарелку	[['мокрый', {'вин,ед'}], ['тарелка', {'вин,ед'}]]
мокром листе	[['мокрый', {'пр,ед'}], ['лист', {'пр,ед'}]]
мокрые кирпичи	[['мокрый', {'вин,мн', 'им,мн'}], ['кирпич', {'вин,мн', 'им,мн'}]]
мокрым комком	[['мокрый', {'твор,ед', 'дат,мн'}], ['комок', {'твор,ед'}]]
мокрые все	[['мокрый', {'вин,мн', 'им,мн'}], ['весь=APRO=им,мн', {'', 'им,ед,сред', 'вин,мн', 'им,мн', 'вин,мн,неод', 'им,ед', 'вин,ед,сред', 'вин,ед'}]]
мокрыми шинами	[['мокрый', {'твор,мн'}], ['шина', {'твор,мн'}]]
мокрый носик	[['мокрый', {'вин,ед', 'им,ед'}], ['носик', {'вин,ед', 'им,ед'}]]
мокрыми улицами	[['мокрый', {'твор,мн'}], ['улица', {'твор,мн'}]]
мокрый пол	[['мокрый', {'вин,ед', 'им,ед'}], ['пол', {'род,мн', 'им,ед', 'вин', 'вин,ед', 'им', 'ед,кр,муж'}]]
мокрая классификация	[['мокрый', {'им,ед'}], ['классификация', {'им,ед'}]]
мокрую подстилку	[['мокрый', {'вин,ед'}], ['подстилка', {'вин,ед'}]]
мокрыми простынями	[['мокрый', {'твор,мн'}], ['простыня', {'твор,мн'}]]
мокрых дров	[['мокрый', {'род,мн', 'вин,мн', 'пр,мн'}], ['дрова', {'род,мн'}]]
мокрые кусты	[['мокрый', {'вин,мн', 'им,мн'}], ['куст', {'вин,мн', 'им,мн'}]]
мокрые костюмы	[['мокрый', {'вин,мн', 'им,мн'}], ['костюм', {'вин,мн', 'им,мн'}]]
мокрой кепки	[['мокрый', {'дат,ед', 'твор,ед', 'род,ед', 'пр,ед'}], ['кепка', {'вин,мн', 'род,ед', 'им,мн'}]]
мокрая собачонка	[['мокрый', {'им,ед'}], ['собачонка', {'вин,ед', 'род,ед', 'им,ед'}]]
мокрых пальто	[['мокрый', {'род,мн', 'вин,мн', 'пр,мн'}], ['пальто', {'род,ед', 'пр,ед', 'род,мн', 'твор,ед', 'вин,мн', 'им,мн', 'дат,мн', 'им,ед', 'твор,мн', 'вин,ед', 'пр,мн', 'дат,ед'}]]
мокрым торцам	[['мокрый', {'твор,ед', 'дат,мн'}], ['торец', {'дат,мн'}]]
мокрым путем	[['мокрый', {'твор,ед', 'дат,мн'}], ['путем=PR=', {'', 'твор,ед'}]]
мокрая масса	[['мокрый', {'им,ед'}], ['масса', {'им,ед'}]]
мокрые скрубберы	[['мокрый', {'вин,мн', 'им,мн'}], ['скруббер', {'вин,мн', 'им,мн'}]]
мокрые глаза	[['мокрый', {'вин,мн', 'им,мн'}], ['глаз', {'вин,мн', 'род,ед', 'им,мн'}]]
мокрому стеклу	[['мокрый', {'дат,ед'}], ['стекло', {'дат,ед'}]]
мокрой майке	[['мокрый', {'дат,ед', 'твор,ед', 'род,ед', 'пр,ед'}], ['майка', {'дат,ед', 'пр,ед'}]]
мокрыми ветками	[['мокрый', {'твор,мн'}], ['ветка', {'твор,мн'}]]
мокрое сиденье	[['мокрый', {'вин,ед', 'им,ед'}], ['сидение', {'вин,ед', 'им,ед', 'пр,ед'}]]
мокрый пес	[['мокрый', {'вин,ед', 'им,ед'}], ['пес', {'им,ед'}]]
мокрого платья	[['мокрый', {'вин,ед', 'род,ед'}], ['платье', {'вин,мн', 'род,ед', 'им,мн'}]]
мокрую мглу	[['мокрый', {'вин,ед'}], ['мгла', {'вин,ед'}]]
мокрых стенах	[['мокрый', {'род,мн', 'вин,мн', 'пр,мн'}], ['стена', {'пр,мн'}]]
мокрой обработки	[['мокрый', {'дат,ед', 'твор,ед', 'род,ед', 'пр,ед'}], ['обработка', {'вин,мн', 'род,ед', 'им,мн'}]]
мокрый купальник	[['мокрый', {'вин,ед', 'им,ед'}], ['купальник', {'вин,ед', 'им,ед'}]]
мокрых одежд	[['мокрый', {'род,мн', 'вин,мн', 'пр,мн'}], ['одежда', {'род,мн'}]]
мокрою тряпкой	[['мокрый', {'твор,ед'}], ['тряпка', {'твор,ед'}]]
мокрых ботинках	[['мокрый', {'род,мн', 'вин,мн', 'пр,мн'}], ['ботинок', {'пр,мн'}]]
мокрые ночи	[['мокрый', {'вин,мн', 'им,мн'}], ['ночь', {'род,ед', 'пр,ед', 'вин,мн', 'им,мн', 'местн,ед', 'дат,ед'}]]
мокром крыльце	[['мокрый', {'пр,ед'}], ['крыльцо', {'пр,ед'}]]
мокрых процессов	[['мокрый', {'род,мн', 'вин,мн', 'пр,мн'}], ['процесс', {'род,мн'}]]
мокрых методов	[['мокрый', {'род,мн', 'вин,мн', 'пр,мн'}], ['метод', {'род,мн'}]]
мокрый сосок	[['мокрый', {'вин,ед', 'им,ед'}], ['сосок', {'вин,ед', 'род,мн', 'им,ед'}]]
мокрыми камнями	[['мокрый', {'твор,мн'}], ['камень', {'твор,мн'}]]
мокрыми бревнами	[['мокрый', {'твор,мн'}], ['бревно', {'твор,мн'}]]
мокрыми листами	[['мокрый', {'твор,мн'}], ['лист', {'твор,мн'}]]
мокрому обогащению	[['мокрый', {'дат,ед'}], ['обогащение', {'дат,ед'}]]
мокрыми шинелями	[['мокрый', {'твор,мн'}], ['шинель', {'твор,мн'}]]
мокрой фуражке	[['мокрый', {'дат,ед', 'твор,ед', 'род,ед', 'пр,ед'}], ['фуражка', {'дат,ед', 'пр,ед'}]]
мокрую пеленку	[['мокрый', {'вин,ед'}], ['пеленка', {'вин,ед'}]]
мокрой веревкой	[['мокрый', {'дат,ед', 'твор,ед', 'род,ед', 'пр,ед'}], ['веревка', {'твор,ед'}]]
мокрые березы	[['мокрый', {'вин,мн', 'им,мн'}], ['береза', {'вин,мн', 'род,ед', 'им,мн'}]]
мокрыми туманами	[['мокрый', {'твор,мн'}], ['туман', {'твор,мн'}]]
мокрые опилки	[['мокрый', {'вин,мн', 'им,мн'}], ['опилки', {'вин,мн', 'им,мн', 'род,ед'}]]
мокрые зерна	[['мокрый', {'вин,мн', 'им,мн'}], ['зерно', {'вин,мн', 'род,ед', 'им,мн'}]]
мокрой шапке	[['мокрый', {'дат,ед', 'твор,ед', 'род,ед', 'пр,ед'}], ['шапка', {'дат,ед', 'пр,ед'}]]
мокрыми ботинками	[['мокрый', {'твор,мн'}], ['ботинок', {'твор,мн'}]]
мокрых обработках	[['мокрый', {'род,мн', 'вин,мн', 'пр,мн'}], ['обработка', {'пр,мн'}]]
мокрые стога	[['мокрый', {'вин,мн', 'им,мн'}], ['стог', {'вин,мн', 'род,ед', 'им,мн'}]]
мокрой соломе	[['мокрый', {'дат,ед', 'твор,ед', 'род,ед', 'пр,ед'}], ['солома', {'дат,ед', 'пр,ед'}]]
мокрых солончаках	[['мокрый', {'род,мн', 'вин,мн', 'пр,мн'}], ['солончак', {'пр,мн'}]]
мокрых глаз	[['мокрый', {'род,мн', 'вин,мн', 'пр,мн'}], ['глаз', {'вин,ед', 'род,мн', 'им,ед'}]]
мокрой щеке	[['мокрый', {'дат,ед', 'твор,ед', 'род,ед', 'пр,ед'}], ['щека', {'дат,ед', 'пр,ед'}]]
мокрого пылеуловителя	[['мокрый', {'вин,ед', 'род,ед'}], ['пылеуловитель', {'род,ед'}]]
мокрый парк	[['мокрый', {'вин,ед', 'им,ед'}], ['парк', {'вин,ед', 'им,ед'}]]
мокром покрытии	[['мокрый', {'пр,ед'}], ['покрытие', {'пр,ед'}]]
мокрой подушки	[['мокрый', {'дат,ед', 'твор,ед', 'род,ед', 'пр,ед'}], ['подушка', {'вин,мн', 'род,ед', 'им,мн'}]]
мокрых садов	[['мокрый', {'род,мн', 'вин,мн', 'пр,мн'}], ['сад', {'род,мн', 'ед,кр,муж'}]]
мокрая прядка	[['мокрый', {'им,ед'}], ['прядка', {'им,ед'}]]
мокрый пиджак	[['мокрый', {'вин,ед', 'им,ед'}], ['пиджак', {'вин,ед', 'им,ед'}]]
мокрый снежок	[['мокрый', {'вин,ед', 'им,ед'}], ['снежок', {'вин,ед', 'им,ед'}]]
мокрую прядь	[['мокрый', {'вин,ед'}], ['прядь', {'вин,ед', 'им,ед'}]]
мокрая дорожка	[['мокрый', {'им,ед'}], ['дорожка', {'им,ед'}]]
мокрую телеграмму	[['мокрый', {'вин,ед'}], ['телеграмма', {'вин,ед'}]]
мокрой тяжестью	[['мокрый', {'дат,ед', 'твор,ед', 'род,ед', 'пр,ед'}], ['тяжесть', {'твор,ед'}]]
мокрым голосом	[['мокрый', {'твор,ед', 'дат,мн'}], ['голос', {'твор,ед'}]]
мокрых камнях	[['мокрый', {'род,мн', 'вин,мн', 'пр,мн'}], ['камень', {'пр,мн'}]]
мокрую поверхность	[['мокрый', {'вин,ед'}], ['поверхность', {'вин,ед', 'им,ед'}]]
мокрой полынью	[['мокрый', {'дат,ед', 'твор,ед', 'род,ед', 'пр,ед'}], ['полынь', {'вин,ед', 'твор,ед'}]]
мокрой штукатурки	[['мокрый', {'дат,ед', 'твор,ед', 'род,ед', 'пр,ед'}], ['штукатурка', {'вин,мн', 'род,ед', 'им,мн'}]]
мокрой сеткой	[['мокрый', {'дат,ед', 'твор,ед', 'род,ед', 'пр,ед'}], ['сетка', {'твор,ед'}]]
мокрые пальцы	[['мокрый', {'вин,мн', 'им,мн'}], ['палец', {'вин,мн', 'им,мн'}]]
мокрую бурку	[['мокрый', {'вин,ед'}], ['бурка', {'вин,ед'}]]
мокрое озоление	[['мокрый', {'вин,ед', 'им,ед'}], ['озоление', {'вин,ед', 'им,ед'}]]
мокрым дорожкам	[['мокрый', {'твор,ед', 'дат,мн'}], ['дорожка', {'дат,мн'}]]
мокрой ваты	[['мокрый', {'дат,ед', 'твор,ед', 'род,ед', 'пр,ед'}], ['вата', {'вин,мн', 'род,ед', 'им,мн'}]]
мокрые комья	[['мокрый', {'вин,мн', 'им,мн'}], ['ком', {'вин,мн', 'им,мн'}]]
мокрой шляпой	[['мокрый', {'дат,ед', 'твор,ед', 'род,ед', 'пр,ед'}], ['шляпа', {'твор,ед'}]]
мокрыми сапогами	[['мокрый', {'твор,мн'}], ['сапог', {'твор,мн'}]]
мокрых выпадений	[['мокрый', {'род,мн', 'вин,мн', 'пр,мн'}], ['выпадение', {'род,мн'}]]
мокрого тумана	[['мокрый', {'вин,ед', 'род,ед'}], ['туман', {'род,ед'}]]
мокрого процесса	[['мокрый', {'вин,ед', 'род,ед'}], ['процесс', {'род,ед'}]]
мокрого камня	[['мокрый', {'вин,ед', 'род,ед'}], ['камень', {'род,ед'}]]
мокрая степь	[['мокрый', {'им,ед'}], ['степь', {'вин,ед', 'им,ед'}]]
мокрыми ноздрями	[['мокрый', {'твор,мн'}], ['ноздря', {'твор,мн'}]]
мокрый песок	[['мокрый', {'вин,ед', 'им,ед'}], ['песок', {'вин,ед', 'им,ед'}]]
мокрых дел	[['мокрый', {'род,мн', 'вин,мн', 'пр,мн'}], ['дело', {'род,мн', 'прош,ед,изъяв,муж,сов'}]]
мокрым телом	[['мокрый', {'твор,ед', 'дат,мн'}], ['тело', {'твор,ед'}]]
мокрых руках	[['мокрый', {'род,мн', 'вин,мн', 'пр,мн'}], ['рука', {'пр,мн'}]]
мокрой головни	[['мокрый', {'дат,ед', 'твор,ед', 'род,ед', 'пр,ед'}], ['головня', {'вин,мн', 'род,ед', 'им,мн'}]]
мокрою спиной	[['мокрый', {'твор,ед'}], ['спина', {'твор,ед'}]]
мокрых операций	[['мокрый', {'род,мн', 'вин,мн', 'пр,мн'}], ['операция', {'род,мн'}]]
мокрый капюшон	[['мокрый', {'вин,ед', 'им,ед'}], ['капюшон', {'вин,ед', 'им,ед'}]]
мокрые столы	[['мокрый', {'вин,мн', 'им,мн'}], ['стол', {'вин,мн', 'им,мн'}]]
мокрый костюм	[['мокрый', {'вин,ед', 'им,ед'}], ['костюм', {'вин,ед', 'им,ед'}]]
мокрых кустов	[['мокрый', {'род,мн', 'вин,мн', 'пр,мн'}], ['куст', {'род,мн', 'им,ед'}]]
мокрой ночи	[['мокрый', {'дат,ед', 'твор,ед', 'род,ед', 'пр,ед'}], ['ночь', {'род,ед', 'пр,ед', 'вин,мн', 'им,мн', 'местн,ед', 'дат,ед'}]]
мокрого окисления	[['мокрый', {'вин,ед', 'род,ед'}], ['окисление', {'вин,мн', 'род,ед', 'им,мн'}]]
мокрую плащ	[['мокрый', {'вин,ед'}], ['плащ', {'вин,ед', 'им,ед'}]]
мокрыми ушами	[['мокрый', {'твор,мн'}], ['ухо', {'твор,мн'}]]
мокрой спины	[['мокрый', {'дат,ед', 'твор,ед', 'род,ед', 'пр,ед'}], ['спина', {'вин,мн', 'род,ед', 'им,мн'}]]
мокрыми ветрами	[['мокрый', {'твор,мн'}], ['ветер', {'твор,мн'}]]
мокром бревне	[['мокрый', {'пр,ед'}], ['бревно', {'пр,ед'}]]
мокрую чащу	[['мокрый', {'вин,ед'}], ['чаща', {'вин,ед', 'непрош,ед,изъяв,1-л'}]]
мокрых рельсах	[['мокрый', {'род,мн', 'вин,мн', 'пр,мн'}], ['рельс', {'пр,мн'}]]
мокрых деревьев	[['мокрый', {'род,мн', 'вин,мн', 'пр,мн'}], ['дерево', {'род,мн'}]]
мокрых мешков	[['мокрый', {'род,мн', 'вин,мн', 'пр,мн'}], ['мешок', {'род,мн', 'вин,мн', 'им,ед'}]]
мокрым полом	[['мокрый', {'твор,ед', 'дат,мн'}], ['пол', {'пр,ед,полн,муж', 'вин,ед', 'твор,ед', 'пр,ед,полн,сред', 'им,ед'}]]
мокрой корой	[['мокрый', {'дат,ед', 'твор,ед', 'род,ед', 'пр,ед'}], ['кора', {'твор,ед'}]]
мокром небе	[['мокрый', {'пр,ед'}], ['небо', {'пр,ед'}]]
мокрой газоочистки	[['мокрый', {'дат,ед', 'твор,ед', 'род,ед', 'пр,ед'}], ['газоочистка', {'вин,мн', 'род,ед', 'им,мн'}]]
мокрого лба	[['мокрый', {'вин,ед', 'род,ед'}], ['лоб', {'род,ед'}]]
мокрая ворона	[['мокрый', {'им,ед'}], ['ворона', {'вин,ед', 'род,ед', 'им,ед'}]]
мокрый круп	[['мокрый', {'вин,ед', 'им,ед'}], ['крупа', {'род,мн', 'вин,ед', 'им,ед'}]]
мокрый бурьян	[['мокрый', {'вин,ед', 'им,ед'}], ['бурьян', {'вин,ед', 'им,ед'}]]
мокрому животу	[['мокрый', {'дат,ед'}], ['живот', {'дат,ед'}]]
мокрого способа	[['мокрый', {'вин,ед', 'род,ед'}], ['способ', {'род,ед'}]]
мокром камне	[['мокрый', {'пр,ед'}], ['камень', {'пр,ед'}]]
мокрый глаз	[['мокрый', {'вин,ед', 'им,ед'}], ['глаз', {'вин,ед', 'род,мн', 'им,ед'}]]
мокрая копна	[['мокрый', {'им,ед'}], ['копна', {'им,ед'}]]
мокрую сирень	[['мокрый', {'вин,ед'}], ['сирень', {'вин,ед', 'им,ед'}]]
мокрых скал	[['мокрый', {'род,мн', 'вин,мн', 'пр,мн'}], ['скала', {'род,мн', 'вин,ед', 'им,ед'}]]
мокрые низины	[['мокрый', {'вин,мн', 'им,мн'}], ['низина', {'вин,мн', 'род,ед', 'им,мн'}]]
мокрую бумажку	[['мокрый', {'вин,ед'}], ['бумажка', {'вин,ед'}]]
мокрому помолу	[['мокрый', {'дат,ед'}], ['помол', {'дат,ед'}]]
мокрыя галки	[['мокрый', {'устар,вин', 'устар,им'}], ['галка', {'род,ед', 'им,мн'}]]
мокрой ватой	[['мокрый', {'дат,ед', 'твор,ед', 'род,ед', 'пр,ед'}], ['вата', {'твор,ед'}]]
мокрых солончаков	[['мокрый', {'род,мн', 'вин,мн', 'пр,мн'}], ['солончак', {'род,мн', 'ед,кр,муж'}]]
мокрый охотник	[['мокрый', {'вин,ед', 'им,ед'}], ['охотник', {'им,ед'}]]
мокрое пятнышко	[['мокрый', {'вин,ед', 'им,ед'}], ['пятнышко', {'вин,ед', 'им,ед'}]]
мокрую одежу	[['мокрый', {'вин,ед'}], ['одежа', {'вин,ед'}]]
мокрым войлоком	[['мокрый', {'твор,ед', 'дат,мн'}], ['войлок', {'твор,ед'}]]
мокрую гниль	[['мокрый', {'вин,ед'}], ['гниль', {'вин,ед', 'им,ед'}]]
мокрому брезенту	[['мокрый', {'дат,ед'}], ['брезент', {'дат,ед'}]]
мокрое протравливание	[['мокрый', {'вин,ед', 'им,ед'}], ['протравливание', {'вин,ед', 'им,ед'}]]
мокром сумраке	[['мокрый', {'пр,ед'}], ['сумрак', {'пр,ед'}]]
мокрую повязку	[['мокрый', {'вин,ед'}], ['повязка', {'вин,ед'}]]
мокрая очистка	[['мокрый', {'им,ед'}], ['очистка', {'им,ед'}]]
мокрую рубашонку	[['мокрый', {'вин,ед'}], ['рубашонка', {'вин,ед'}]]
мокрых тряпках	[['мокрый', {'род,мн', 'вин,мн', 'пр,мн'}], ['тряпка', {'пр,мн'}]]
мокрую тряпицу	[['мокрый', {'вин,ед'}], ['тряпица', {'вин,ед'}]]
мокрой тундре	[['мокрый', {'дат,ед', 'твор,ед', 'род,ед', 'пр,ед'}], ['тундра', {'дат,ед', 'пр,ед'}]]
мокрые ноги	[['мокрый', {'вин,мн', 'им,мн'}], ['нога', {'вин,мн', 'род,ед', 'им,мн'}]]
мокрой куртке	[['мокрый', {'дат,ед', 'твор,ед', 'род,ед', 'пр,ед'}], ['куртка', {'дат,ед', 'пр,ед'}]]
мокрого снегопада	[['мокрый', {'вин,ед', 'род,ед'}], ['снегопад', {'род,ед'}]]
мокрой руке	[['мокрый', {'дат,ед', 'твор,ед', 'род,ед', 'пр,ед'}], ['рука', {'дат,ед', 'пр,ед'}]]
мокрая головня	[['мокрый', {'им,ед'}], ['головня', {'им,ед'}]]
мокрые городки	[['мокрый', {'вин,мн', 'им,мн'}], ['городок', {'вин,мн', 'им,мн'}]]
мокрые губки	[['мокрый', {'вин,мн', 'им,мн'}], ['губка', {'вин,мн', 'род,ед', 'им,мн'}]]
мокрыми клочьями	[['мокрый', {'твор,мн'}], ['клок', {'твор,мн'}]]
мокрой улицы	[['мокрый', {'дат,ед', 'твор,ед', 'род,ед', 'пр,ед'}], ['улица', {'вин,мн', 'род,ед', 'им,мн'}]]
мокрую мелочь	[['мокрый', {'вин,ед'}], ['мелочь', {'вин,ед', 'им,ед'}]]
мокрой древесиной	[['мокрый', {'дат,ед', 'твор,ед', 'род,ед', 'пр,ед'}], ['древесина', {'твор,ед'}]]
мокрый узел	[['мокрый', {'вин,ед', 'им,ед'}], ['узел', {'вин,ед', 'им,ед'}]]
мокрой косынкой	[['мокрый', {'дат,ед', 'твор,ед', 'род,ед', 'пр,ед'}], ['косынка', {'твор,ед'}]]
мокрой темноты	[['мокрый', {'дат,ед', 'твор,ед', 'род,ед', 'пр,ед'}], ['темнота', {'род,ед'}]]
мокрую трясину	[['мокрый', {'вин,ед'}], ['трясина', {'вин,ед'}]]
мокрый дождевик	[['мокрый', {'вин,ед', 'им,ед'}], ['дождевик', {'вин,ед', 'им,ед'}]]
мокрыми золоуловителями	[['мокрый', {'твор,мн'}], ['золоуловитель', {'твор,мн'}]]
мокрыя простыни	[['мокрый', {'устар,вин', 'устар,им'}], ['простыня', {'вин,мн', 'род,ед', 'им,мн'}]]
мокрый мяч	[['мокрый', {'вин,ед', 'им,ед'}], ['мяч', {'вин,ед', 'им,ед'}]]
мокрой доске	[['мокрый', {'дат,ед', 'твор,ед', 'род,ед', 'пр,ед'}], ['доска', {'дат,ед', 'пр,ед'}]]
мокрую стойку	[['мокрый', {'вин,ед'}], ['стойка', {'вин,ед'}]]
мокрым мешком	[['мокрый', {'твор,ед', 'дат,мн'}], ['мешок', {'твор,ед'}]]
мокрый Васька	[['мокрый', {'вин,ед', 'им,ед'}], ['васька', {'вин,ед', 'род,ед', 'им,ед'}]]
мокрые трубы	[['мокрый', {'вин,мн', 'им,мн'}], ['труба', {'вин,мн', 'род,ед', 'им,мн'}]]
мокрой ваткой	[['мокрый', {'дат,ед', 'твор,ед', 'род,ед', 'пр,ед'}], ['ватка', {'твор,ед'}]]
мокрые комочки	[['мокрый', {'вин,мн', 'им,мн'}], ['комочек', {'вин,мн', 'им,мн'}]]
мокрой щеткою	[['мокрый', {'дат,ед', 'твор,ед', 'род,ед', 'пр,ед'}], ['щетка', {'твор,ед'}]]
мокрых почвах	[['мокрый', {'род,мн', 'вин,мн', 'пр,мн'}], ['почва', {'пр,мн'}]]
мокрые сосны	[['мокрый', {'вин,мн', 'им,мн'}], ['сосна', {'вин,мн', 'род,ед', 'им,мн'}]]
мокрых бровей	[['мокрый', {'род,мн', 'вин,мн', 'пр,мн'}], ['бровь', {'род,мн'}]]
мокрой челкой	[['мокрый', {'дат,ед', 'твор,ед', 'род,ед', 'пр,ед'}], ['челка', {'твор,ед'}]]
мокрую девочку	[['мокрый', {'вин,ед'}], ['девочка', {'вин,ед'}]]
мокрыми плетьми	[['мокрый', {'твор,мн'}], ['плеть', {'твор,мн'}]]
мокрые снега	[['мокрый', {'вин,мн', 'им,мн'}], ['снег', {'вин,мн', 'род,ед', 'им,мн'}]]
мокрых сетей	[['мокрый', {'род,мн', 'вин,мн', 'пр,мн'}], ['сеть', {'род,мн'}]]
мокрыми перьями	[['мокрый', {'твор,мн'}], ['перо', {'твор,мн'}]]
мокрый глянец	[['мокрый', {'вин,ед', 'им,ед'}], ['глянец', {'вин,ед', 'им,ед'}]]
мокрых цветов	[['мокрый', {'род,мн', 'вин,мн', 'пр,мн'}], ['цветок', {'род,мн'}]]
мокрая рубашка	[['мокрый', {'им,ед'}], ['рубашка', {'им,ед'}]]
мокром грунте	[['мокрый', {'пр,ед'}], ['грунт', {'пр,ед'}]]
мокрым сжиганием	[['мокрый', {'твор,ед', 'дат,мн'}], ['сжигание', {'твор,ед'}]]
мокрые скамейки	[['мокрый', {'вин,мн', 'им,мн'}], ['скамейка', {'вин,мн', 'род,ед', 'им,мн'}]]
мокрому песку	[['мокрый', {'дат,ед'}], ['песок', {'парт,ед', 'дат,ед'}]]
мокрая полоса	[['мокрый', {'им,ед'}], ['полоса', {'им,ед'}]]
мокрых конях	[['мокрый', {'род,мн', 'вин,мн', 'пр,мн'}], ['конь', {'пр,мн'}]]
мокром зеркале	[['мокрый', {'пр,ед'}], ['зеркало', {'пр,ед'}]]
мокрых ладонях	[['мокрый', {'род,мн', 'вин,мн', 'пр,мн'}], ['ладонь', {'пр,мн'}]]
мокрого теленка	[['мокрый', {'вин,ед', 'род,ед'}], ['теленок', {'вин,ед', 'род,ед'}]]
мокрые тряпки	[['мокрый', {'вин,мн', 'им,мн'}], ['тряпка', {'вин,мн', 'род,ед', 'им,мн'}]]
мокрое плечо	[['мокрый', {'вин,ед', 'им,ед'}], ['плечо', {'вин,ед', 'им,ед'}]]
мокрых портянок	[['мокрый', {'род,мн', 'вин,мн', 'пр,мн'}], ['портянка', {'род,мн'}]]
мокрым воздухом	[['мокрый', {'твор,ед', 'дат,мн'}], ['воздух', {'твор,ед'}]]
мокрые его	[['мокрый', {'вин,мн', 'им,мн'}], ['он=SPRO,ед,3-л,муж=вин', {'род,мн,сред', 'дат,мн', 'вин,ед,жен', 'дат,ед,жен', 'пр,мн,муж', 'твор,ед,сред', 'дат,мн,муж', 'род,ед,жен', 'им,мн,сред', 'твор,ед,муж', 'им,ед,сред', 'им,мн', 'род,ед,сред', 'твор,мн,сред', 'дат,ед,сред', 'вин,мн,муж', 'им,ед,муж', 'им,ед,жен', 'твор,ед,жен', 'пр,мн,сред', 'род,мн', 'вин,мн,од', 'пр,ед,жен', 'дат,ед,муж', 'вин,ед,сред', 'пр,ед,сред', 'пр,мн', 'вин,ед,муж,неод', 'вин,мн,сред', 'род,ед', 'род,ед,муж', 'вин,мн,неод', 'вин,ед,муж,од', 'твор,мн', 'дат,мн,сред', 'вин,ед,муж', 'пр,ед,муж', 'вин,ед'}]]
мокрым носом	[['мокрый', {'твор,ед', 'дат,мн'}], ['нос', {'твор,ед'}]]
мокрым способами	[['мокрый', {'твор,ед', 'дат,мн'}], ['способ', {'твор,мн'}]]
мокрой бумаге	[['мокрый', {'дат,ед', 'твор,ед', 'род,ед', 'пр,ед'}], ['бумага', {'дат,ед', 'пр,ед'}]]
мокрой соли	[['мокрый', {'дат,ед', 'твор,ед', 'род,ед', 'пр,ед'}], ['соль', {'род,ед', 'пр,ед', 'ед,пов,2-л', 'вин,мн', 'им,мн', 'дат,ед'}]]
мокрыми зонтиками	[['мокрый', {'твор,мн'}], ['зонтик', {'твор,мн'}]]
мокрого товара	[['мокрый', {'вин,ед', 'род,ед'}], ['товар', {'род,ед'}]]
мокрую сорочку	[['мокрый', {'вин,ед'}], ['сорочка', {'вин,ед'}]]
мокрой щекой	[['мокрый', {'дат,ед', 'твор,ед', 'род,ед', 'пр,ед'}], ['щека', {'твор,ед'}]]
мокрыми ветвями	[['мокрый', {'твор,мн'}], ['ветвь', {'твор,мн'}]]
мокрую амуницию	[['мокрый', {'вин,ед'}], ['амуниция', {'вин,ед'}]]
мокрых газгольдеров	[['мокрый', {'род,мн', 'вин,мн', 'пр,мн'}], ['газгольдер', {'род,мн'}]]
мокрым жгутом	[['мокрый', {'твор,ед', 'дат,мн'}], ['жгут', {'твор,ед'}]]
мокрые тополя	[['мокрый', {'вин,мн', 'им,мн'}], ['тополь', {'вин,ед', 'вин,мн', 'род,ед', 'им,мн'}]]
мокрую пыль	[['мокрый', {'вин,ед'}], ['пыль', {'вин,ед', 'им,ед'}]]
мокрый бушлат	[['мокрый', {'вин,ед', 'им,ед'}], ['бушлат', {'вин,ед', 'им,ед'}]]
мокрые снежинки	[['мокрый', {'вин,мн', 'им,мн'}], ['снежинка', {'вин,мн', 'род,ед', 'им,мн'}]]
мокрых сосен	[['мокрый', {'род,мн', 'вин,мн', 'пр,мн'}], ['сосна', {'род,мн', 'ед,кр,муж'}]]
мокрых тротуаров	[['мокрый', {'род,мн', 'вин,мн', 'пр,мн'}], ['тротуар', {'род,мн'}]]
мокрые веревки	[['мокрый', {'вин,мн', 'им,мн'}], ['веревка', {'вин,мн', 'род,ед', 'им,мн'}]]
мокрой грязи	[['мокрый', {'дат,ед', 'твор,ед', 'род,ед', 'пр,ед'}], ['грязь', {'дат,ед', 'вин,мн', 'род,ед', 'им,мн', 'пр,ед'}]]
мокрого пятна	[['мокрый', {'вин,ед', 'род,ед'}], ['пятно', {'вин,мн', 'род,ед', 'им,мн'}]]
мокрой вьюгой	[['мокрый', {'дат,ед', 'твор,ед', 'род,ед', 'пр,ед'}], ['вьюга', {'твор,ед'}]]
мокрые листы	[['мокрый', {'вин,мн', 'им,мн'}], ['лист', {'вин,мн', 'им,мн'}]]
мокрому камню	[['мокрый', {'дат,ед'}], ['камень', {'дат,ед'}]]
мокрые их	[['мокрый', {'вин,мн', 'им,мн'}], ['они=SPRO,мн=вин', {'род,мн,сред', 'дат,мн', 'вин,ед,жен', 'дат,ед,жен', 'пр,мн,муж', 'твор,ед,сред', 'дат,мн,муж', 'род,ед,жен', 'им,мн,сред', 'твор,ед,муж', 'им,ед,сред', 'им,мн', 'род,ед,сред', 'твор,мн,сред', 'дат,ед,сред', 'вин,мн,муж', 'им,ед,муж', 'им,ед,жен', 'твор,ед,жен', 'пр,мн,сред', 'род,мн', 'вин,мн,од', 'вин,мн', 'пр,ед,жен', 'дат,ед,муж', 'вин,ед,сред', 'пр,ед,сред', 'пр,мн', 'вин,ед,муж,неод', 'вин,мн,сред', 'род,ед,муж', 'вин,мн,неод', 'вин,ед,муж,од', 'твор,мн', 'дат,мн,сред', 'вин,ед,муж', 'пр,ед,муж'}]]
мокрую постель	[['мокрый', {'вин,ед'}], ['постель', {'вин,ед', 'им,ед'}]]
мокрым зонтиком	[['мокрый', {'твор,ед', 'дат,мн'}], ['зонтик', {'твор,ед'}]]
мокром теле	[['мокрый', {'пр,ед'}], ['тело', {'', 'пр,ед'}]]
мокрую губку	[['мокрый', {'вин,ед'}], ['губка', {'вин,ед'}]]
мокрых досок	[['мокрый', {'род,мн', 'вин,мн', 'пр,мн'}], ['доска', {'род,мн'}]]
мокром сене	[['мокрый', {'пр,ед'}], ['сено', {'дат,ед', 'пр,ед'}]]
мокрый язык	[['мокрый', {'вин,ед', 'им,ед'}], ['язык', {'вин,ед', 'им,ед'}]]
мокрый я	[['мокрый', {'вин,ед', 'им,ед'}], ['я=SPRO,ед,1-л=им', {'род,ед', 'пр,ед', 'род,мн', 'твор,ед', 'вин,мн', 'им,мн', 'дат,мн', 'им,ед', 'твор,мн', 'вин,ед', 'пр,мн', 'дат,ед'}]]
мокром тротуаре	[['мокрый', {'пр,ед'}], ['тротуар', {'пр,ед'}]]
мокрого термометров	[['мокрый', {'вин,ед', 'род,ед'}], ['термометр', {'род,мн'}]]
мокрые деревья	[['мокрый', {'вин,мн', 'им,мн'}], ['дерево', {'вин,мн', 'им,мн'}]]
мокрого сена	[['мокрый', {'вин,ед', 'род,ед'}], ['сено', {'вин,ед', 'вин,мн', 'род,ед', 'им,мн', 'им,ед'}]]
мокрая галька	[['мокрый', {'им,ед'}], ['галька', {'вин,ед', 'род,ед', 'им,ед'}]]
мокрые заросли	[['мокрый', {'вин,мн', 'им,мн'}], ['заросль', {'род,ед', 'пр,ед', 'вин,мн', 'им,мн', 'прош,мн,изъяв,сов', 'дат,ед'}]]
мокрым прахом	[['мокрый', {'твор,ед', 'дат,мн'}], ['прах', {'твор,ед'}]]
мокрой шапкой	[['мокрый', {'дат,ед', 'твор,ед', 'род,ед', 'пр,ед'}], ['шапка', {'твор,ед'}]]
мокрым камням	[['мокрый', {'твор,ед', 'дат,мн'}], ['камень', {'дат,мн'}]]
мокром бурьяне	[['мокрый', {'пр,ед'}], ['бурьян', {'пр,ед'}]]
мокрое окно	[['мокрый', {'вин,ед', 'им,ед'}], ['окно', {'вин,ед', 'им,ед'}]]
мокрыми лапами	[['мокрый', {'твор,мн'}], ['лапа', {'твор,мн'}]]
мокрым булыжникам	[['мокрый', {'твор,ед', 'дат,мн'}], ['булыжник', {'дат,мн'}]]
мокрой стены	[['мокрый', {'дат,ед', 'твор,ед', 'род,ед', 'пр,ед'}], ['стена', {'вин,мн', 'род,ед', 'им,мн'}]]
мокрой листвы	[['мокрый', {'дат,ед', 'твор,ед', 'род,ед', 'пр,ед'}], ['листва', {'род,ед'}]]
мокрые лепестки	[['мокрый', {'вин,мн', 'им,мн'}], ['лепесток', {'вин,мн', 'им,мн'}]]
мокрого дня	[['мокрый', {'вин,ед', 'род,ед'}], ['день', {'род,ед'}]]
мокрые хвосты	[['мокрый', {'вин,мн', 'им,мн'}], ['хвост', {'вин,мн', 'им,мн'}]]
мокром окопе	[['мокрый', {'пр,ед'}], ['окоп', {'пр,ед'}]]
мокрого пепла	[['мокрый', {'вин,ед', 'род,ед'}], ['пепел', {'род,ед'}]]
мокрые рукава	[['мокрый', {'вин,мн', 'им,мн'}], ['рукав', {'вин,мн', 'род,ед', 'им,мн'}]]
мокрого бурения	[['мокрый', {'вин,ед', 'род,ед'}], ['бурение', {'вин,мн', 'род,ед', 'им,мн'}]]
мокрые люди	[['мокрый', {'вин,мн', 'им,мн'}], ['человек', {'им,мн'}]]
мокрой древесины	[['мокрый', {'дат,ед', 'твор,ед', 'род,ед', 'пр,ед'}], ['древесина', {'вин,мн', 'род,ед', 'им,мн'}]]
мокрых улицах	[['мокрый', {'род,мн', 'вин,мн', 'пр,мн'}], ['улица', {'пр,мн'}]]
мокрого перрона	[['мокрый', {'вин,ед', 'род,ед'}], ['перрон', {'род,ед'}]]
мокрых бревен	[['мокрый', {'род,мн', 'вин,мн', 'пр,мн'}], ['бревно', {'род,мн'}]]
мокрые щели	[['мокрый', {'вин,мн', 'им,мн'}], ['щель', {'дат,ед', 'вин,мн', 'род,ед', 'им,мн', 'пр,ед'}]]
мокрому ветру	[['мокрый', {'дат,ед'}], ['ветер', {'местн,ед', 'дат,ед'}]]
мокрым зонтом	[['мокрый', {'твор,ед', 'дат,мн'}], ['зонт', {'твор,ед'}]]
мокрого посола	[['мокрый', {'вин,ед', 'род,ед'}], ['посол', {'род,ед'}]]
мокрыми веревочками	[['мокрый', {'твор,мн'}], ['веревочка', {'твор,мн'}]]
мокрыми головами	[['мокрый', {'твор,мн'}], ['голова', {'твор,мн'}]]
мокрые тряпицы	[['мокрый', {'вин,мн', 'им,мн'}], ['тряпица', {'вин,мн', 'род,ед', 'им,мн'}]]
мокрой гривой	[['мокрый', {'дат,ед', 'твор,ед', 'род,ед', 'пр,ед'}], ['грива', {'твор,ед'}]]
мокрое дно	[['мокрый', {'вин,ед', 'им,ед'}], ['дно', {'вин,ед', 'им,ед'}]]
мокрые сучья	[['мокрый', {'вин,мн', 'им,мн'}], ['сук', {'вин,мн', 'им,мн', 'им,ед,жен'}]]
мокрые тротуары	[['мокрый', {'вин,мн', 'им,мн'}], ['тротуар', {'вин,мн', 'им,мн'}]]
мокрых зарослях	[['мокрый', {'род,мн', 'вин,мн', 'пр,мн'}], ['заросль', {'пр,мн'}]]
мокрой вьюге	[['мокрый', {'дат,ед', 'твор,ед', 'род,ед', 'пр,ед'}], ['вьюга', {'дат,ед', 'пр,ед'}]]
мокрая лошадь	[['мокрый', {'им,ед'}], ['лошадь', {'вин,ед', 'им,ед'}]]
мокрому перрону	[['мокрый', {'дат,ед'}], ['перрон', {'дат,ед'}]]
мокрое перо	[['мокрый', {'вин,ед', 'им,ед'}], ['перо', {'вин,ед', 'им,ед'}]]
мокрых крыш	[['мокрый', {'род,мн', 'вин,мн', 'пр,мн'}], ['крыша', {'род,мн'}]]
мокрыми пятнами	[['мокрый', {'твор,мн'}], ['пятно', {'твор,мн'}]]
мокрого тушения	[['мокрый', {'вин,ед', 'род,ед'}], ['тушение', {'вин,мн', 'род,ед', 'им,мн'}]]
мокрою курицею	[['мокрый', {'твор,ед'}], ['курица', {'твор,ед'}]]
мокрого золоулавливания	[['мокрый', {'вин,ед', 'род,ед'}], ['золоулавливание', {'вин,мн', 'род,ед', 'им,мн'}]]
мокрым спинам	[['мокрый', {'твор,ед', 'дат,мн'}], ['спина', {'дат,мн'}]]
мокрым ртом	[['мокрый', {'твор,ед', 'дат,мн'}], ['рот', {'твор,ед'}]]
мокрый щенок	[['мокрый', {'вин,ед', 'им,ед'}], ['щенок', {'им,ед'}]]
мокрой губкой	[['мокрый', {'дат,ед', 'твор,ед', 'род,ед', 'пр,ед'}], ['губка', {'твор,ед'}]]
мокрыми пеленками	[['мокрый', {'твор,мн'}], ['пеленка', {'твор,мн'}]]
мокрого хранения	[['мокрый', {'вин,ед', 'род,ед'}], ['хранение', {'вин,мн', 'род,ед', 'им,мн'}]]
мокрыя ноги	[['мокрый', {'устар,вин', 'устар,им'}], ['нога', {'вин,мн', 'род,ед', 'им,мн'}]]
мокрые полы	[['мокрый', {'вин,мн', 'им,мн'}], ['пол', {'мн,кр', 'вин,мн', 'им,мн', 'род,ед'}]]
мокрым туманом	[['мокрый', {'твор,ед', 'дат,мн'}], ['туман', {'твор,ед'}]]
мокрый войлок	[['мокрый', {'вин,ед', 'им,ед'}], ['войлок', {'вин,ед', 'им,ед'}]]
мокрой ниткой	[['мокрый', {'дат,ед', 'твор,ед', 'род,ед', 'пр,ед'}], ['нитка', {'твор,ед'}]]
мокрой губки	[['мокрый', {'дат,ед', 'твор,ед', 'род,ед', 'пр,ед'}], ['губка', {'вин,мн', 'род,ед', 'им,мн'}]]
мокрую погоду	[['мокрый', {'вин,ед'}], ['погода', {'вин,ед'}]]
мокрыми делами	[['мокрый', {'твор,мн'}], ['дело', {'твор,мн'}]]
мокрыми глазками	[['мокрый', {'твор,мн'}], ['глазок', {'твор,мн'}]]
мокрой рюмки	[['мокрый', {'дат,ед', 'твор,ед', 'род,ед', 'пр,ед'}], ['рюмка', {'вин,мн', 'род,ед', 'им,мн'}]]
мокрый мешок	[['мокрый', {'вин,ед', 'им,ед'}], ['мешок', {'вин,ед', 'им,ед'}]]
мокрый карцер	[['мокрый', {'вин,ед', 'им,ед'}], ['карцер', {'вин,ед', 'им,ед'}]]
мокрого щенка	[['мокрый', {'вин,ед', 'род,ед'}], ['щенок', {'вин,ед', 'род,ед'}]]
мокрые чулки	[['мокрый', {'вин,мн', 'им,мн'}], ['чулок', {'вин,мн', 'им,мн'}]]
мокрую массу	[['мокрый', {'вин,ед'}], ['масса', {'вин,ед'}]]
мокрым платьем	[['мокрый', {'твор,ед', 'дат,мн'}], ['платье', {'твор,ед'}]]
мокрой гальки	[['мокрый', {'дат,ед', 'твор,ед', 'род,ед', 'пр,ед'}], ['галька', {'вин,мн', 'род,ед', 'им,мн'}]]
мокрые веники	[['мокрый', {'вин,мн', 'им,мн'}], ['веник', {'вин,мн', 'им,мн'}]]
мокрый брезент	[['мокрый', {'вин,ед', 'им,ед'}], ['брезент', {'вин,ед', 'им,ед'}]]
мокрые плиты	[['мокрый', {'вин,мн', 'им,мн'}], ['плита', {'вин,мн', 'род,ед', 'им,мн'}]]
мокрым петухом	[['мокрый', {'твор,ед', 'дат,мн'}], ['петух', {'твор,ед'}]]
мокрых грунтов	[['мокрый', {'род,мн', 'вин,мн', 'пр,мн'}], ['грунт', {'род,мн', 'ед,кр,муж'}]]
мокрыми канатами	[['мокрый', {'твор,мн'}], ['канат', {'твор,мн'}]]
мокрую накидку	[['мокрый', {'вин,ед'}], ['накидка', {'вин,ед'}]]
мокрые шеи	[['мокрый', {'вин,мн', 'им,мн'}], ['шея', {'вин,мн', 'род,ед', 'им,мн'}]]
мокрые ягоды	[['мокрый', {'вин,мн', 'им,мн'}], ['ягода', {'вин,мн', 'род,ед', 'им,мн'}]]
мокрой веревки	[['мокрый', {'дат,ед', 'твор,ед', 'род,ед', 'пр,ед'}], ['веревка', {'вин,мн', 'род,ед', 'им,мн'}]]
мокрую почву	[['мокрый', {'вин,ед'}], ['почва', {'вин,ед'}]]
мокрых забоях	[['мокрый', {'род,мн', 'вин,мн', 'пр,мн'}], ['забой', {'пр,мн'}]]
мокрого ветра	[['мокрый', {'вин,ед', 'род,ед'}], ['ветер', {'вин,мн', 'род,ед', 'им,мн'}]]
мокрым хвостом	[['мокрый', {'твор,ед', 'дат,мн'}], ['хвост', {'твор,ед'}]]
мокрая юбка	[['мокрый', {'им,ед'}], ['юбка', {'им,ед'}]]
мокрых песков	[['мокрый', {'род,мн', 'вин,мн', 'пр,мн'}], ['песок', {'род,мн', 'им,ед'}]]
мокрую газету	[['мокрый', {'вин,ед'}], ['газета', {'вин,ед'}]]
мокрый кошелек	[['мокрый', {'вин,ед', 'им,ед'}], ['кошелек', {'вин,ед', 'им,ед'}]]
мокром сожжении	[['мокрый', {'пр,ед'}], ['сожжение', {'пр,ед'}]]
мокрый узелок	[['мокрый', {'вин,ед', 'им,ед'}], ['узелок', {'вин,ед', 'им,ед'}]]
мокрые улицы	[['мокрый', {'вин,мн', 'им,мн'}], ['улица', {'вин,мн', 'род,ед', 'им,мн'}]]
мокрыми следами	[['мокрый', {'твор,мн'}], ['след', {'твор,мн'}]]
мокрой тряпкой	[['мокрый', {'дат,ед', 'твор,ед', 'род,ед', 'пр,ед'}], ['тряпка', {'твор,ед'}]]
мокрой глиной	[['мокрый', {'дат,ед', 'твор,ед', 'род,ед', 'пр,ед'}], ['глина', {'твор,ед'}]]
мокрое облако	[['мокрый', {'вин,ед', 'им,ед'}], ['облако', {'вин,ед', 'им,ед'}]]
мокрой курице	[['мокрый', {'дат,ед', 'твор,ед', 'род,ед', 'пр,ед'}], ['курица', {'дат,ед', 'пр,ед'}]]
мокрой варежкой	[['мокрый', {'дат,ед', 'твор,ед', 'род,ед', 'пр,ед'}], ['варежка', {'твор,ед'}]]
мокрое одеяло	[['мокрый', {'вин,ед', 'им,ед'}], ['одеяло', {'вин,ед', 'им,ед'}]]
мокрое дробление	[['мокрый', {'вин,ед', 'им,ед'}], ['дробление', {'вин,ед', 'им,ед'}]]
мокрую губу	[['мокрый', {'вин,ед'}], ['губа', {'вин,ед'}]]
мокрыми солончаками	[['мокрый', {'твор,мн'}], ['солончак', {'твор,мн'}]]
мокрого человека	[['мокрый', {'вин,ед', 'род,ед'}], ['человек', {'вин,ед', 'род,ед'}]]
мокрым рукавом	[['мокрый', {'твор,ед', 'дат,мн'}], ['рукав', {'твор,ед'}]]
мокрой спине	[['мокрый', {'дат,ед', 'твор,ед', 'род,ед', 'пр,ед'}], ['спина', {'дат,ед', 'пр,ед'}]]
мокрый холод	[['мокрый', {'вин,ед', 'им,ед'}], ['холод', {'вин,ед', 'им,ед'}]]
мокрый хром	[['мокрый', {'вин,ед', 'им,ед'}], ['хром', {'вин,ед', 'ед,кр,муж', 'им,ед'}]]
мокрых лохмотьев	[['мокрый', {'род,мн', 'вин,мн', 'пр,мн'}], ['лохмотья', {'род,мн'}]]
мокрый способъ	[['мокрый', {'вин,ед', 'им,ед'}], ['способ', {'вин,ед', 'им,ед'}]]
мокрой платформе	[['мокрый', {'дат,ед', 'твор,ед', 'род,ед', 'пр,ед'}], ['платформа', {'дат,ед', 'пр,ед'}]]
мокрый воробей	[['мокрый', {'вин,ед', 'им,ед'}], ['воробей', {'им,ед'}]]
мокрый мех	[['мокрый', {'вин,ед', 'им,ед'}], ['мех', {'вин,ед', 'им,ед'}]]
мокрой газетой	[['мокрый', {'дат,ед', 'твор,ед', 'род,ед', 'пр,ед'}], ['газета', {'твор,ед'}]]
мокром костюме	[['мокрый', {'пр,ед'}], ['костюм', {'пр,ед'}]]
мокром саду	[['мокрый', {'пр,ед'}], ['сад', {'местн,ед', 'дат,ед'}]]
мокрым рельсам	[['мокрый', {'твор,ед', 'дат,мн'}], ['рельс', {'дат,мн'}]]
мокрой листве	[['мокрый', {'дат,ед', 'твор,ед', 'род,ед', 'пр,ед'}], ['листва', {'дат,ед', 'пр,ед'}]]
мокрую шапку	[['мокрый', {'вин,ед'}], ['шапка', {'вин,ед'}]]
мокрым бельем	[['мокрый', {'твор,ед', 'дат,мн'}], ['белье', {'твор,ед'}]]
мокрый нос	[['мокрый', {'вин,ед', 'им,ед'}], ['нос', {'вин,ед', 'им,ед'}]]
мокрой рубашкой	[['мокрый', {'дат,ед', 'твор,ед', 'род,ед', 'пр,ед'}], ['рубашка', {'твор,ед'}]]
мокрая подушка	[['мокрый', {'им,ед'}], ['подушка', {'им,ед'}]]
мокрое солнце	[['мокрый', {'вин,ед', 'им,ед'}], ['солнце', {'вин,ед', 'им,ед', 'пр,ед'}]]
мокрым асфальтом	[['мокрый', {'твор,ед', 'дат,мн'}], ['асфальт', {'твор,ед'}]]
мокрыми плащами	[['мокрый', {'твор,мн'}], ['плащ', {'твор,мн'}]]
мокрой сирени	[['мокрый', {'дат,ед', 'твор,ед', 'род,ед', 'пр,ед'}], ['сирень', {'дат,ед', 'вин,мн', 'род,ед', 'им,мн', 'пр,ед'}]]
мокрым одеялом	[['мокрый', {'твор,ед', 'дат,мн'}], ['одеяло', {'твор,ед'}]]
мокрая вата	[['мокрый', {'им,ед'}], ['вата', {'вин,ед', 'род,ед', 'им,ед'}]]
мокрыми прядями	[['мокрый', {'твор,мн'}], ['прядь', {'твор,мн'}]]
мокрому насту	[['мокрый', {'дат,ед'}], ['наст', {'дат,ед'}]]
мокрых местах	[['мокрый', {'род,мн', 'вин,мн', 'пр,мн'}], ['место', {'пр,мн'}]]
мокрому телу	[['мокрый', {'дат,ед'}], ['тело', {'дат,ед'}]]
мокром состоянии	[['мокрый', {'пр,ед'}], ['состояние', {'пр,ед'}]]
мокрые участки	[['мокрый', {'вин,мн', 'им,мн'}], ['участок', {'вин,мн', 'им,мн'}]]
мокрого железа	[['мокрый', {'вин,ед', 'род,ед'}], ['железо', {'вин,мн', 'род,ед', 'им,мн', 'им,ед'}]]
мокрой дорожке	[['мокрый', {'дат,ед', 'твор,ед', 'род,ед', 'пр,ед'}], ['дорожка', {'дат,ед', 'пр,ед'}]]
мокрые гнили	[['мокрый', {'вин,мн', 'им,мн'}], ['гниль', {'прош,мн,изъяв', 'род,ед', 'пр,ед', 'вин,мн', 'им,мн', 'дат,ед'}]]
мокрую полосу	[['мокрый', {'вин,ед'}], ['полоса', {'вин,ед'}]]
мокрая траншея	[['мокрый', {'им,ед'}], ['траншея', {'им,ед'}]]
мокрого способов	[['мокрый', {'вин,ед', 'род,ед'}], ['способ', {'род,мн'}]]
мокрый невод	[['мокрый', {'вин,ед', 'им,ед'}], ['невод', {'вин,ед', 'им,ед'}]]
мокрого сжигания	[['мокрый', {'вин,ед', 'род,ед'}], ['сжигание', {'вин,мн', 'род,ед', 'им,мн'}]]
мокрыми стволами	[['мокрый', {'твор,мн'}], ['ствол', {'твор,мн'}]]
мокрых снежинок	[['мокрый', {'род,мн', 'вин,мн', 'пр,мн'}], ['снежинка', {'род,мн'}]]
мокром космосе	[['мокрый', {'пр,ед'}], ['космос', {'пр,ед'}]]
мокрые платья	[['мокрый', {'вин,мн', 'им,мн'}], ['платье', {'вин,мн', 'род,ед', 'им,мн'}]]
мокрой кочке	[['мокрый', {'дат,ед', 'твор,ед', 'род,ед', 'пр,ед'}], ['кочка', {'дат,ед', 'пр,ед'}]]
мокрая солома	[['мокрый', {'им,ед'}], ['солома', {'им,ед'}]]
мокрым концом	[['мокрый', {'твор,ед', 'дат,мн'}], ['конец', {'твор,ед'}]]
мокрыми веревками	[['мокрый', {'твор,мн'}], ['веревка', {'твор,мн'}]]
мокрых лошадей	[['мокрый', {'род,мн', 'вин,мн', 'пр,мн'}], ['лошадь', {'род,мн', 'вин,мн'}]]
мокрой марлей	[['мокрый', {'дат,ед', 'твор,ед', 'род,ед', 'пр,ед'}], ['марля', {'род,мн', 'твор,ед'}]]
мокром режиме	[['мокрый', {'пр,ед'}], ['режим', {'пр,ед'}]]
мокрая прядь	[['мокрый', {'им,ед'}], ['прядь', {'вин,ед', 'им,ед'}]]
мокрой щебенке	[['мокрый', {'дат,ед', 'твор,ед', 'род,ед', 'пр,ед'}], ['щебенка', {'дат,ед', 'пр,ед'}]]
мокрая вода	[['мокрый', {'им,ед'}], ['вода', {'род,ед', 'им,ед'}]]
мокрые дела	[['мокрый', {'вин,мн', 'им,мн'}], ['дело', {'прош,ед,изъяв,жен,сов', 'вин,мн', 'род,ед', 'им,мн'}]]
мокрых лугов	[['мокрый', {'род,мн', 'вин,мн', 'пр,мн'}], ['луг', {'род,мн'}]]
мокрая простыня	[['мокрый', {'им,ед'}], ['простыня', {'им,ед'}]]
мокрой спиной	[['мокрый', {'дат,ед', 'твор,ед', 'род,ед', 'пр,ед'}], ['спина', {'твор,ед'}]]
мокрого гранита	[['мокрый', {'вин,ед', 'род,ед'}], ['гранит', {'род,ед', 'им,ед'}]]
мокрые варежки	[['мокрый', {'вин,мн', 'им,мн'}], ['варежка', {'вин,мн', 'род,ед', 'им,мн'}]]
мокрых препаратов	[['мокрый', {'род,мн', 'вин,мн', 'пр,мн'}], ['препарат', {'род,мн'}]]
мокрыми курицами	[['мокрый', {'твор,мн'}], ['курица', {'твор,мн'}]]
мокрому стволу	[['мокрый', {'дат,ед'}], ['ствол', {'дат,ед'}]]
мокрые рельсы	[['мокрый', {'вин,мн', 'им,мн'}], ['рельс', {'вин,мн', 'им,мн'}]]
мокрые стали	[['мокрый', {'вин,мн', 'им,мн'}], ['становиться=V,нп=прош,мн,изъяв,сов', {'род,ед', 'пр,ед', 'вин,мн', 'им,мн', 'прош,мн,изъяв,сов', 'дат,ед'}]]
мокрого рассева	[['мокрый', {'вин,ед', 'род,ед'}], ['рассев', {'род,ед'}]]
мокрых золоуловителях	[['мокрый', {'род,мн', 'вин,мн', 'пр,мн'}], ['золоуловитель', {'пр,мн'}]]
мокрой юбкой	[['мокрый', {'дат,ед', 'твор,ед', 'род,ед', 'пр,ед'}], ['юбка', {'твор,ед'}]]
мокрую мешковину	[['мокрый', {'вин,ед'}], ['мешковина', {'вин,ед'}]]
мокрая шкура	[['мокрый', {'им,ед'}], ['шкура', {'им,ед'}]]
мокрые очки	[['мокрый', {'вин,мн', 'им,мн'}], ['очки', {'вин,мн', 'им,мн'}]]
мокрых улиц	[['мокрый', {'род,мн', 'вин,мн', 'пр,мн'}], ['улица', {'род,мн'}]]
мокром отрепье	[['мокрый', {'пр,ед'}], ['отрепье', {'вин,ед', 'им,ед', 'пр,ед'}]]
мокрыми облаками	[['мокрый', {'твор,мн'}], ['облако', {'твор,мн'}]]
мокрой кожей	[['мокрый', {'дат,ед', 'твор,ед', 'род,ед', 'пр,ед'}], ['кожа', {'твор,ед'}]]
мокрого золоуловителя	[['мокрый', {'вин,ед', 'род,ед'}], ['золоуловитель', {'род,ед'}]]
мокром пиджаке	[['мокрый', {'пр,ед'}], ['пиджак', {'пр,ед'}]]
мокрое письмо	[['мокрый', {'вин,ед', 'им,ед'}], ['письмо', {'вин,ед', 'им,ед'}]]
мокром сжигании	[['мокрый', {'пр,ед'}], ['сжигание', {'пр,ед'}]]
мокрой темноте	[['мокрый', {'дат,ед', 'твор,ед', 'род,ед', 'пр,ед'}], ['темнота', {'дат,ед', 'пр,ед'}]]
мокрый пылеуловитель	[['мокрый', {'вин,ед', 'им,ед'}], ['пылеуловитель', {'вин,ед', 'им,ед'}]]
мокрых следов	[['мокрый', {'род,мн', 'вин,мн', 'пр,мн'}], ['след', {'род,мн'}]]
мокрый мир	[['мокрый', {'вин,ед', 'им,ед'}], ['мир', {'вин,ед', 'род,мн', 'вин,мн', 'им,ед'}]]
мокрых тополей	[['мокрый', {'род,мн', 'вин,мн', 'пр,мн'}], ['тополь', {'род,мн', 'вин,мн'}]]
мокрые разводы	[['мокрый', {'вин,мн', 'им,мн'}], ['развод', {'вин,мн', 'им,мн'}]]
мокрым железом	[['мокрый', {'твор,ед', 'дат,мн'}], ['железо', {'твор,ед'}]]
мокрую бороду	[['мокрый', {'вин,ед'}], ['борода', {'вин,ед'}]]
мокрый ворот	[['мокрый', {'вин,ед', 'им,ед'}], ['ворота', {'род,мн', 'вин,ед', 'им,ед'}]]
мокрые полоски	[['мокрый', {'вин,мн', 'им,мн'}], ['полоска', {'вин,мн', 'род,ед', 'им,мн'}]]
мокрой штукатуркой	[['мокрый', {'дат,ед', 'твор,ед', 'род,ед', 'пр,ед'}], ['штукатурка', {'твор,ед'}]]
мокрую стенку	[['мокрый', {'вин,ед'}], ['стенка', {'вин,ед'}]]
мокром лице	[['мокрый', {'пр,ед'}], ['лицо', {'пр,ед'}]]
мокрые доски	[['мокрый', {'вин,мн', 'им,мн'}], ['доска', {'вин,мн', 'род,ед', 'им,мн'}]]
мокрых тряпок	[['мокрый', {'род,мн', 'вин,мн', 'пр,мн'}], ['тряпка', {'род,мн', 'вин,мн'}]]
мокром коне	[['мокрый', {'пр,ед'}], ['конь', {'пр,ед'}]]
мокром платье	[['мокрый', {'пр,ед'}], ['платье', {'вин,ед', 'им,ед', 'пр,ед'}]]
мокрых чекменей	[['мокрый', {'род,мн', 'вин,мн', 'пр,мн'}], ['чекмень', {'род,мн'}]]
мокрых перчатках	[['мокрый', {'род,мн', 'вин,мн', 'пр,мн'}], ['перчатка', {'пр,мн'}]]
мокром деле	[['мокрый', {'пр,ед'}], ['дело', {'пр,ед'}]]
мокрым углем	[['мокрый', {'твор,ед', 'дат,мн'}], ['уголь', {'твор,ед'}]]
мокрых бульварах	[['мокрый', {'род,мн', 'вин,мн', 'пр,мн'}], ['бульвар', {'пр,мн'}]]
мокрым полотнищем	[['мокрый', {'твор,ед', 'дат,мн'}], ['полотнище', {'твор,ед'}]]
мокрый валежник	[['мокрый', {'вин,ед', 'им,ед'}], ['валежник', {'вин,ед', 'им,ед'}]]
мокрых солонцов	[['мокрый', {'род,мн', 'вин,мн', 'пр,мн'}], ['солонец', {'род,мн', 'ед,кр,муж'}]]
мокрой воды	[['мокрый', {'дат,ед', 'твор,ед', 'род,ед', 'пр,ед'}], ['вода', {'вин,мн', 'род,ед', 'им,мн'}]]
мокрый башлык	[['мокрый', {'вин,ед', 'им,ед'}], ['башлык', {'вин,ед', 'им,ед'}]]
мокрой тряпке	[['мокрый', {'дат,ед', 'твор,ед', 'род,ед', 'пр,ед'}], ['тряпка', {'дат,ед', 'пр,ед'}]]
мокрой обуви	[['мокрый', {'дат,ед', 'твор,ед', 'род,ед', 'пр,ед'}], ['обувь', {'дат,ед', 'вин,мн', 'род,ед', 'им,мн', 'пр,ед'}]]
мокрым мхом	[['мокрый', {'твор,ед', 'дат,мн'}], ['мох', {'твор,ед'}]]
мокрый способ	[['мокрый', {'вин,ед', 'им,ед'}], ['способ', {'вин,ед', 'им,ед'}]]
мокрой солью	[['мокрый', {'дат,ед', 'твор,ед', 'род,ед', 'пр,ед'}], ['соль', {'твор,ед', 'непрош,ед,изъяв,1-л,сов'}]]
мокрому термометру	[['мокрый', {'дат,ед'}], ['термометр', {'дат,ед'}]]
мокрому папоротнику	[['мокрый', {'дат,ед'}], ['папоротник', {'дат,ед'}]]
мокрой шерсткой	[['мокрый', {'дат,ед', 'твор,ед', 'род,ед', 'пр,ед'}], ['шерстка', {'твор,ед'}]]
мокрый кулак	[['мокрый', {'вин,ед', 'им,ед'}], ['кулак', {'вин,ед', 'им,ед'}]]
мокрый карман	[['мокрый', {'вин,ед', 'им,ед'}], ['карман', {'вин,ед', 'род,мн', 'им,ед'}]]
мокрою повязкой	[['мокрый', {'твор,ед'}], ['повязка', {'твор,ед'}]]
мокрым глянцем	[['мокрый', {'твор,ед', 'дат,мн'}], ['глянец', {'твор,ед'}]]
мокрого ствола	[['мокрый', {'вин,ед', 'род,ед'}], ['ствол', {'род,ед'}]]
мокрого измельчения	[['мокрый', {'вин,ед', 'род,ед'}], ['измельчение', {'вин,мн', 'род,ед', 'им,мн'}]]
мокрый холодок	[['мокрый', {'вин,ед', 'им,ед'}], ['холодок', {'вин,ед', 'им,ед'}]]
мокрой резиной	[['мокрый', {'дат,ед', 'твор,ед', 'род,ед', 'пр,ед'}], ['резина', {'дат,ед', 'твор,ед', 'род,ед', 'пр,ед'}]]
мокрые перила	[['мокрый', {'вин,мн', 'им,мн'}], ['перила', {'вин,мн', 'им,мн'}]]
мокрых рубах	[['мокрый', {'род,мн', 'вин,мн', 'пр,мн'}], ['рубаха', {'род,мн', 'пр,мн'}]]
мокрыми скрубберами	[['мокрый', {'твор,мн'}], ['скруббер', {'твор,мн'}]]
мокрые солдаты	[['мокрый', {'вин,мн', 'им,мн'}], ['солдат', {'им,мн'}]]
мокрому методу	[['мокрый', {'дат,ед'}], ['метод', {'вин,ед', 'дат,ед'}]]
мокрой плащ	[['мокрый', {'дат,ед', 'твор,ед', 'род,ед', 'пр,ед'}], ['плащ', {'вин,ед', 'им,ед'}]]
мокрые цветы	[['мокрый', {'вин,мн', 'им,мн'}], ['цветок', {'вин,мн', 'им,мн', 'род,ед'}]]
мокрую одежонку	[['мокрый', {'вин,ед'}], ['одежонка', {'вин,ед'}]]
мокрого газгольдера	[['мокрый', {'вин,ед', 'род,ед'}], ['газгольдер', {'род,ед'}]]
мокрым бревнам	[['мокрый', {'твор,ед', 'дат,мн'}], ['бревно', {'дат,мн'}]]
мокрые чубы	[['мокрый', {'вин,мн', 'им,мн'}], ['чуб', {'вин,мн', 'им,мн'}]]
мокрую траву	[['мокрый', {'вин,ед'}], ['трава', {'вин,ед'}]]
мокрых платьях	[['мокрый', {'род,мн', 'вин,мн', 'пр,мн'}], ['платье', {'пр,мн'}]]
мокрая ночь	[['мокрый', {'им,ед'}], ['ночь', {'вин,ед', 'им,ед'}]]
мокрые гимнастерки	[['мокрый', {'вин,мн', 'им,мн'}], ['гимнастерка', {'вин,мн', 'род,ед', 'им,мн'}]]
мокрые тряпочки	[['мокрый', {'вин,мн', 'им,мн'}], ['тряпочка', {'вин,мн', 'род,ед', 'им,мн'}]]
мокрое колесо	[['мокрый', {'вин,ед', 'им,ед'}], ['колесо', {'вин,ед', 'им,ед'}]]
мокрых куриц	[['мокрый', {'род,мн', 'вин,мн', 'пр,мн'}], ['курица', {'род,мн', 'вин,мн'}]]
мокрую простыню	[['мокрый', {'вин,ед'}], ['простыня', {'вин,ед'}]]
мокрый капитан	[['мокрый', {'вин,ед', 'им,ед'}], ['капитан', {'им,ед'}]]
мокрых стволов	[['мокрый', {'род,мн', 'вин,мн', 'пр,мн'}], ['ствол', {'род,мн', 'ед,кр,муж'}]]
мокрые юбки	[['мокрый', {'вин,мн', 'им,мн'}], ['юбка', {'вин,мн', 'род,ед', 'им,мн'}]]
мокрым кашлем	[['мокрый', {'твор,ед', 'дат,мн'}], ['кашель', {'твор,ед'}]]
мокрыя места	[['мокрый', {'устар,вин', 'устар,им'}], ['место', {'вин,мн', 'род,ед', 'им,мн'}]]
мокрою губкой	[['мокрый', {'твор,ед'}], ['губка', {'твор,ед'}]]
мокрая обувь	[['мокрый', {'им,ед'}], ['обувь', {'вин,ед', 'им,ед'}]]
мокрыми штанами	[['мокрый', {'твор,мн'}], ['штаны', {'твор,мн'}]]
мокрой лысиной	[['мокрый', {'дат,ед', 'твор,ед', 'род,ед', 'пр,ед'}], ['лысина', {'твор,ед'}]]
мокром берегу	[['мокрый', {'пр,ед'}], ['берег', {'местн,ед', 'непрош,ед,изъяв,1-л', 'дат,ед'}]]
мокрое дело	[['мокрый', {'вин,ед', 'им,ед'}], ['дело', {'вин,ед', 'им,ед', 'прош,ед,изъяв,сред,сов'}]]
мокрым аллеям	[['мокрый', {'твор,ед', 'дат,мн'}], ['аллея', {'дат,мн'}]]
мокрой тундрой	[['мокрый', {'дат,ед', 'твор,ед', 'род,ед', 'пр,ед'}], ['тундра', {'твор,ед'}]]
мокрый бредень	[['мокрый', {'вин,ед', 'им,ед'}], ['бредень', {'вин,ед', 'им,ед'}]]
мокрая шапка	[['мокрый', {'им,ед'}], ['шапка', {'им,ед'}]]
мокрая кошка	[['мокрый', {'им,ед'}], ['кошка', {'им,ед'}]]
мокрых электрофильтров	[['мокрый', {'род,мн', 'вин,мн', 'пр,мн'}], ['электрофильтр', {'род,мн'}]]
мокрыми полами	[['мокрый', {'твор,мн'}], ['пол', {'твор,мн'}]]
мокрого дерева	[['мокрый', {'вин,ед', 'род,ед'}], ['дерево', {'вин,мн', 'род,ед', 'им,мн'}]]
мокрый слой	[['мокрый', {'вин,ед', 'им,ед'}], ['слой', {'вин,ед', 'им,ед'}]]
мокрому плечу	[['мокрый', {'дат,ед'}], ['плечо', {'дат,ед'}]]
мокрых лаптях	[['мокрый', {'род,мн', 'вин,мн', 'пр,мн'}], ['лапоть', {'пр,мн'}]]
мокрые весла	[['мокрый', {'вин,мн', 'им,мн'}], ['весло', {'вин,мн', 'род,ед', 'им,мн'}]]
мокрыми волосами	[['мокрый', {'твор,мн'}], ['волос', {'твор,мн'}]]
мокрое днище	[['мокрый', {'вин,ед', 'им,ед'}], ['днище', {'вин,ед', 'им,ед', 'пр,ед'}]]
мокрая тьма	[['мокрый', {'им,ед'}], ['тьма', {'им,ед'}]]
мокрой салфеткой	[['мокрый', {'дат,ед', 'твор,ед', 'род,ед', 'пр,ед'}], ['салфетка', {'твор,ед'}]]
мокрых делах	[['мокрый', {'род,мн', 'вин,мн', 'пр,мн'}], ['дело', {'пр,мн'}]]
мокрыми воронами	[['мокрый', {'твор,мн'}], ['ворона', {'твор,мн'}]]
мокрые места	[['мокрый', {'вин,мн', 'им,мн'}], ['место', {'вин,мн', 'род,ед', 'им,мн'}]]
мокраго платья	[['мокрый', {'устар,вин', 'устар,род'}], ['платье', {'вин,мн', 'род,ед', 'им,мн'}]]
мокрую палубу	[['мокрый', {'вин,ед'}], ['палуба', {'вин,ед'}]]
мокрой лестнице	[['мокрый', {'дат,ед', 'твор,ед', 'род,ед', 'пр,ед'}], ['лестница', {'дат,ед', 'пр,ед'}]]
мокрая рука	[['мокрый', {'им,ед'}], ['рука', {'им,ед'}]]
мокрой золой	[['мокрый', {'дат,ед', 'твор,ед', 'род,ед', 'пр,ед'}], ['зола', {'твор,ед'}]]
мокрыми валенками	[['мокрый', {'твор,мн'}], ['валенок', {'твор,мн'}]]
мокрой ржи	[['мокрый', {'дат,ед', 'твор,ед', 'род,ед', 'пр,ед'}], ['рожь', {'род,ед', 'пр,ед', 'ед,пов,2-л', 'вин,мн', 'им,мн', 'дат,ед'}]]
мокрый комочек	[['мокрый', {'вин,ед', 'им,ед'}], ['комочек', {'вин,ед', 'им,ед'}]]
мокрой рубахой	[['мокрый', {'дат,ед', 'твор,ед', 'род,ед', 'пр,ед'}], ['рубаха', {'твор,ед'}]]
мокрою толпой	[['мокрый', {'твор,ед'}], ['толпа', {'', 'твор,ед'}]]
мокрые лапти	[['мокрый', {'вин,мн', 'им,мн'}], ['лапоть', {'вин,мн', 'им,мн'}]]
мокрой штукатурке	[['мокрый', {'дат,ед', 'твор,ед', 'род,ед', 'пр,ед'}], ['штукатурка', {'дат,ед', 'пр,ед'}]]
мокрые перья	[['мокрый', {'вин,мн', 'им,мн'}], ['перо', {'вин,мн', 'им,мн'}]]
мокрому бетону	[['мокрый', {'дат,ед'}], ['бетон', {'дат,ед'}]]
мокрых одеждах	[['мокрый', {'род,мн', 'вин,мн', 'пр,мн'}], ['одежда', {'пр,мн'}]]
мокрые луга	[['мокрый', {'вин,мн', 'им,мн'}], ['луг', {'вин,мн', 'род,ед', 'им,мн', 'им,ед'}]]
мокрой лошади	[['мокрый', {'дат,ед', 'твор,ед', 'род,ед', 'пр,ед'}], ['лошадь', {'дат,ед', 'род,ед', 'им,мн', 'пр,ед'}]]
мокрыми глазами	[['мокрый', {'твор,мн'}], ['глаз', {'твор,мн'}]]
мокрые препараты	[['мокрый', {'вин,мн', 'им,мн'}], ['препарат', {'вин,мн', 'им,мн'}]]
мокрая его	[['мокрый', {'им,ед'}], ['он=SPRO,ед,3-л,муж=вин', {'род,мн,сред', 'дат,мн', 'вин,ед,жен', 'дат,ед,жен', 'пр,мн,муж', 'твор,ед,сред', 'дат,мн,муж', 'род,ед,жен', 'им,мн,сред', 'твор,ед,муж', 'им,ед,сред', 'им,мн', 'род,ед,сред', 'твор,мн,сред', 'дат,ед,сред', 'вин,мн,муж', 'им,ед,муж', 'им,ед,жен', 'твор,ед,жен', 'пр,мн,сред', 'род,мн', 'вин,мн,од', 'пр,ед,жен', 'дат,ед,муж', 'вин,ед,сред', 'пр,ед,сред', 'пр,мн', 'вин,ед,муж,неод', 'вин,мн,сред', 'род,ед', 'род,ед,муж', 'вин,мн,неод', 'вин,ед,муж,од', 'твор,мн', 'дат,мн,сред', 'вин,ед,муж', 'пр,ед,муж', 'вин,ед'}]]
мокрые ракиты	[['мокрый', {'вин,мн', 'им,мн'}], ['ракита', {'вин,мн', 'род,ед', 'им,мн'}]]
мокрую рубашку	[['мокрый', {'вин,ед'}], ['рубашка', {'вин,ед'}]]
мокрые забои	[['мокрый', {'вин,мн', 'им,мн'}], ['забой', {'вин,мн', 'им,мн'}]]
мокрые хребты	[['мокрый', {'вин,мн', 'им,мн'}], ['хребет', {'вин,мн', 'им,мн'}]]
мокрой известкой	[['мокрый', {'дат,ед', 'твор,ед', 'род,ед', 'пр,ед'}], ['известка', {'твор,ед'}]]
мокрой клеенкой	[['мокрый', {'дат,ед', 'твор,ед', 'род,ед', 'пр,ед'}], ['клеенка', {'твор,ед'}]]
мокрой палатке	[['мокрый', {'дат,ед', 'твор,ед', 'род,ед', 'пр,ед'}], ['палатка', {'дат,ед', 'пр,ед'}]]
мокрых кож	[['мокрый', {'род,мн', 'вин,мн', 'пр,мн'}], ['кожа', {'род,мн'}]]
мокрый лес	[['мокрый', {'вин,ед', 'им,ед'}], ['лес', {'вин,ед', 'род,мн', 'им,ед'}]]
мокрыми кистями	[['мокрый', {'твор,мн'}], ['кисть', {'твор,мн'}]]
мокрой головы	[['мокрый', {'дат,ед', 'твор,ед', 'род,ед', 'пр,ед'}], ['голова', {'вин,мн', 'род,ед', 'им,мн'}]]
мокрых туч	[['мокрый', {'род,мн', 'вин,мн', 'пр,мн'}], ['туча', {'род,мн'}]]
мокрую черноту	[['мокрый', {'вин,ед'}], ['чернота', {'вин,ед'}]]
мокрым ступенькам	[['мокрый', {'твор,ед', 'дат,мн'}], ['ступенька', {'дат,мн'}]]
мокрую полу	[['мокрый', {'вин,ед'}], ['пол', {'', 'пр', 'местн,ед', 'вин,ед', 'дат', 'род', 'твор', 'дат,ед'}]]
мокрые одежды	[['мокрый', {'вин,мн', 'им,мн'}], ['одежда', {'вин,мн', 'род,ед', 'им,мн'}]]
мокрую доску	[['мокрый', {'вин,ед'}], ['доска', {'вин,ед'}]]
мокрой бумагой	[['мокрый', {'дат,ед', 'твор,ед', 'род,ед', 'пр,ед'}], ['бумага', {'твор,ед'}]]
мокрого неба	[['мокрый', {'вин,ед', 'род,ед'}], ['небо', {'вин,мн', 'род,ед', 'им,мн'}]]
мокрый рукав	[['мокрый', {'вин,ед', 'им,ед'}], ['рукав', {'вин,ед', 'им,ед'}]]
мокрым снежком	[['мокрый', {'твор,ед', 'дат,мн'}], ['снежок', {'вин,ед', 'твор,ед', 'им,ед'}]]
мокрые следы	[['мокрый', {'вин,мн', 'им,мн'}], ['след', {'вин,мн', 'им,мн'}]]
мокрые крыши	[['мокрый', {'вин,мн', 'им,мн'}], ['крыша', {'вин,мн', 'род,ед', 'им,мн'}]]
мокрой одежи	[['мокрый', {'дат,ед', 'твор,ед', 'род,ед', 'пр,ед'}], ['одежа', {'вин,мн', 'род,ед', 'им,мн'}]]
мокрых цветах	[['мокрый', {'род,мн', 'вин,мн', 'пр,мн'}], ['цвет', {'пр,мн'}]]
мокрые бурьяны	[['мокрый', {'вин,мн', 'им,мн'}], ['бурьян', {'вин,мн', 'им,мн'}]]
мокрые шлепки	[['мокрый', {'вин,мн', 'им,мн'}], ['шлепок', {'вин,мн', 'им,мн', 'род,ед'}]]
мокрым ногам	[['мокрый', {'твор,ед', 'дат,мн'}], ['нога', {'дат,мн'}]]
мокрыми ресницами	[['мокрый', {'твор,мн'}], ['ресница', {'твор,мн'}]]
мокрая тряпка	[['мокрый', {'им,ед'}], ['тряпка', {'им,ед'}]]
мокрыми кожами	[['мокрый', {'твор,мн'}], ['кожа', {'твор,мн'}]]
мокрой пряжи	[['мокрый', {'дат,ед', 'твор,ед', 'род,ед', 'пр,ед'}], ['пряжа', {'вин,мн', 'род,ед', 'им,мн'}]]
мокрые птицы	[['мокрый', {'вин,мн', 'им,мн'}], ['птица', {'род,ед', 'им,мн'}]]
мокрым крупом	[['мокрый', {'твор,ед', 'дат,мн'}], ['круп', {'твор,ед'}]]
мокрые подолы	[['мокрый', {'вин,мн', 'им,мн'}], ['подол', {'вин,мн', 'им,мн'}]]
мокрой очистке	[['мокрый', {'дат,ед', 'твор,ед', 'род,ед', 'пр,ед'}], ['очистка', {'дат,ед', 'пр,ед'}]]
мокрой тресты	[['мокрый', {'дат,ед', 'твор,ед', 'род,ед', 'пр,ед'}], ['трест', {'вин,мн', 'им,мн', 'род,ед'}]]
мокрый порох	[['мокрый', {'вин,ед', 'им,ед'}], ['порох', {'вин,ед', 'им,ед'}]]
мокрым блеском	[['мокрый', {'твор,ед', 'дат,мн'}], ['блеск', {'твор,ед'}]]
мокрого сожжения	[['мокрый', {'вин,ед', 'род,ед'}], ['сожжение', {'вин,мн', 'род,ед', 'им,мн'}]]
мокрые заборы	[['мокрый', {'вин,мн', 'им,мн'}], ['забор', {'вин,мн', 'им,мн'}]]
мокрых носках	[['мокрый', {'род,мн', 'вин,мн', 'пр,мн'}], ['носок', {'пр,мн'}]]
мокрое лето	[['мокрый', {'вин,ед', 'им,ед'}], ['лето', {'вин,ед', 'им,ед'}]]
мокрыми салфетками	[['мокрый', {'твор,мн'}], ['салфетка', {'твор,мн'}]]
мокрых перил	[['мокрый', {'род,мн', 'вин,мн', 'пр,мн'}], ['перила', {'род,мн'}]]
мокрых лохмотьях	[['мокрый', {'род,мн', 'вин,мн', 'пр,мн'}], ['лохмотья', {'пр,мн'}]]
мокрые порты	[['мокрый', {'вин,мн', 'им,мн'}], ['порт', {'вин,мн', 'им,мн'}]]
мокрым снегопадом	[['мокрый', {'твор,ед', 'дат,мн'}], ['снегопад', {'твор,ед'}]]
мокрой щеткой	[['мокрый', {'дат,ед', 'твор,ед', 'род,ед', 'пр,ед'}], ['щетка', {'твор,ед'}]]
мокрыми хвостами	[['мокрый', {'твор,мн'}], ['хвост', {'твор,мн'}]]
мокрой капусты	[['мокрый', {'дат,ед', 'твор,ед', 'род,ед', 'пр,ед'}], ['капуста', {'вин,мн', 'род,ед', 'им,мн'}]]
мокрые стены	[['мокрый', {'вин,мн', 'им,мн'}], ['стена', {'вин,мн', 'род,ед', 'им,мн'}]]
мокрой тонкошеей	[['мокрый', {'дат,ед', 'твор,ед', 'род,ед', 'пр,ед'}], ['тонкошея', {'пр,ед,полн,жен', 'твор,ед', 'дат,ед,полн,жен', 'род,ед,полн,жен', 'твор,ед,полн,жен'}]]
мокрыми повязками	[['мокрый', {'твор,мн'}], ['повязка', {'твор,мн'}]]
мокрый окоп	[['мокрый', {'вин,ед', 'им,ед'}], ['окоп', {'вин,ед', 'им,ед'}]]
мокрым навозом	[['мокрый', {'твор,ед', 'дат,мн'}], ['навоз', {'твор,ед'}]]
мокрыми курами	[['мокрый', {'твор,мн'}], ['курица', {'твор,мн'}]]
мокрой уборки	[['мокрый', {'дат,ед', 'твор,ед', 'род,ед', 'пр,ед'}], ['уборка', {'вин,мн', 'род,ед', 'им,мн'}]]
мокрую грязь	[['мокрый', {'вин,ед'}], ['грязь', {'вин,ед', 'им,ед'}]]
мокрая пыль	[['мокрый', {'им,ед'}], ['пыль', {'вин,ед', 'им,ед'}]]
мокрыми подошвами	[['мокрый', {'твор,мн'}], ['подошва', {'твор,мн'}]]
мокром льду	[['мокрый', {'пр,ед'}], ['лед', {'парт,ед', 'местн,ед', 'дат,ед'}]]
мокрыми лесами	[['мокрый', {'твор,мн'}], ['лес', {'твор,мн'}]]
мокрою рукой	[['мокрый', {'твор,ед'}], ['рука', {'твор,ед'}]]
мокра шинель	[['мокрый', {'ед,кр'}], ['шинель', {'вин,ед', 'им,ед'}]]
мокрому способам	[['мокрый', {'дат,ед'}], ['способ', {'дат,мн'}]]
мокрые кочки	[['мокрый', {'вин,мн', 'им,мн'}], ['кочка', {'вин,мн', 'род,ед', 'им,мн'}]]
мокрую морду	[['мокрый', {'вин,ед'}], ['морда', {'вин,ед'}]]
мокрых рук	[['мокрый', {'род,мн', 'вин,мн', 'пр,мн'}], ['рука', {'род,мн'}]]
мокрые куски	[['мокрый', {'вин,мн', 'им,мн'}], ['кусок', {'вин,мн', 'им,мн'}]]
мокрому крупу	[['мокрый', {'дат,ед'}], ['крупа', {'вин,ед', 'дат,ед'}]]
мокромъ платье	[['мокрый', {'пр,ед'}], ['платье', {'вин,ед', 'им,ед', 'пр,ед'}]]
мокрую мостовую	[['мокрый', {'вин,ед'}], ['мостовая', {'вин,ед', 'вин,ед,полн,жен', 'вин,ед,жен'}]]
мокрою тряпкою	[['мокрый', {'твор,ед'}], ['тряпка', {'твор,ед'}]]
мокрое железо	[['мокрый', {'вин,ед', 'им,ед'}], ['железо', {'вин,ед', 'им,ед'}]]
мокрые водоросли	[['мокрый', {'вин,мн', 'им,мн'}], ['водоросль', {'дат,ед', 'вин,мн', 'род,ед', 'им,мн', 'пр,ед'}]]
мокрым льдом	[['мокрый', {'твор,ед', 'дат,мн'}], ['лед', {'твор,ед'}]]
мокрыми рогожами	[['мокрый', {'твор,мн'}], ['рогожа', {'твор,мн'}]]
мокрыя тряпки	[['мокрый', {'устар,вин', 'устар,им'}], ['тряпка', {'вин,мн', 'род,ед', 'им,мн'}]]
мокрой бороде	[['мокрый', {'дат,ед', 'твор,ед', 'род,ед', 'пр,ед'}], ['борода', {'дат,ед', 'пр,ед'}]]
мокрые стекла	[['мокрый', {'вин,мн', 'им,мн'}], ['стекло', {'прош,ед,изъяв,жен,сов', 'вин,мн', 'род,ед', 'им,мн'}]]
мокрая голова	[['мокрый', {'им,ед'}], ['голова', {'вин,ед', 'род,ед', 'им,ед'}]]
мокрых простынь	[['мокрый', {'род,мн', 'вин,мн', 'пр,мн'}], ['простыня', {'род,мн', 'ед,пов,2-л', 'ед,пов,2-л,сов'}]]
мокрые дни	[['мокрый', {'вин,мн', 'им,мн'}], ['день', {'вин,мн', 'им,мн'}]]
мокрый метод	[['мокрый', {'вин,ед', 'им,ед'}], ['метод', {'вин,ед', 'род,мн', 'им,ед'}]]
мокрых отходов	[['мокрый', {'род,мн', 'вин,мн', 'пр,мн'}], ['отходы', {'род,мн'}]]
мокрое сожжение	[['мокрый', {'вин,ед', 'им,ед'}], ['сожжение', {'вин,ед', 'им,ед'}]]
мокрые полотенца	[['мокрый', {'вин,мн', 'им,мн'}], ['полотенце', {'вин,мн', 'род,ед', 'им,мн'}]]
мокрыми веками	[['мокрый', {'твор,мн'}], ['век', {'твор,мн'}]]
мокрый уголь	[['мокрый', {'вин,ед', 'им,ед'}], ['уголь', {'вин,ед', 'им,ед'}]]
мокрые поручни	[['мокрый', {'вин,мн', 'им,мн'}], ['поручень', {'вин,мн', 'им,мн'}]]
мокрыми дровами	[['мокрый', {'твор,мн'}], ['дрова', {'твор,мн'}]]
мокрые бинты	[['мокрый', {'вин,мн', 'им,мн'}], ['бинт', {'вин,мн', 'им,мн'}]]
мокрые клочки	[['мокрый', {'вин,мн', 'им,мн'}], ['клочок', {'вин,мн', 'им,мн'}]]
мокрые щеки	[['мокрый', {'вин,мн', 'им,мн'}], ['щека', {'вин,мн', 'род,ед', 'им,мн'}]]
мокрые дороги	[['мокрый', {'вин,мн', 'им,мн'}], ['дорога', {'мн,кр', 'вин,мн', 'род,ед', 'им,мн'}]]
мокрым дорогам	[['мокрый', {'твор,ед', 'дат,мн'}], ['дорога', {'дат,мн'}]]
мокрой земли	[['мокрый', {'дат,ед', 'твор,ед', 'род,ед', 'пр,ед'}], ['земля', {'вин,мн', 'род,ед', 'им,мн'}]]
мокрый пепел	[['мокрый', {'вин,ед', 'им,ед'}], ['пепел', {'вин,ед', 'им,ед'}]]
мокрого асфальта	[['мокрый', {'вин,ед', 'род,ед'}], ['асфальт', {'род,ед'}]]
мокрое бурение	[['мокрый', {'вин,ед', 'им,ед'}], ['бурение', {'вин,ед', 'им,ед'}]]
мокрой ветке	[['мокрый', {'дат,ед', 'твор,ед', 'род,ед', 'пр,ед'}], ['ветка', {'дат,ед', 'пр,ед'}]]
мокрый электрофильтр	[['мокрый', {'вин,ед', 'им,ед'}], ['электрофильтр', {'вин,ед', 'им,ед'}]]
мокром стекле	[['мокрый', {'пр,ед'}], ['стекло', {'пр,ед'}]]
мокрой панели	[['мокрый', {'дат,ед', 'твор,ед', 'род,ед', 'пр,ед'}], ['панель', {'дат,ед', 'вин,мн', 'род,ед', 'им,мн', 'пр,ед'}]]
мокрыми пятками	[['мокрый', {'твор,мн'}], ['пятка', {'твор,мн'}]]
мокрый волос	[['мокрый', {'вин,ед', 'им,ед'}], ['волос', {'вин,ед', 'род,мн', 'им,ед'}]]
мокрые фильтры	[['мокрый', {'вин,мн', 'им,мн'}], ['фильтр', {'вин,мн', 'им,мн'}]]
мокрого грохочения	[['мокрый', {'вин,ед', 'род,ед'}], ['грохочение', {'вин,мн', 'род,ед', 'им,мн'}]]
мокрых балок	[['мокрый', {'род,мн', 'вин,мн', 'пр,мн'}], ['балка', {'род,мн', 'вин,ед', 'им,ед'}]]
мокрая листва	[['мокрый', {'им,ед'}], ['листва', {'им,ед'}]]
мокрых скрубберах	[['мокрый', {'род,мн', 'вин,мн', 'пр,мн'}], ['скруббер', {'пр,мн'}]]
мокрый поцелуй	[['мокрый', {'вин,ед', 'им,ед'}], ['поцелуй', {'вин,ед', 'ед,пов,2-л', 'им,ед'}]]
мокрую ночь	[['мокрый', {'вин,ед'}], ['ночь', {'вин,ед', 'им,ед'}]]
мокрые тела	[['мокрый', {'вин,мн', 'им,мн'}], ['тело', {'вин,мн', 'род,ед', 'им,мн'}]]
мокрой подушке	[['мокрый', {'дат,ед', 'твор,ед', 'род,ед', 'пр,ед'}], ['подушка', {'дат,ед', 'пр,ед'}]]
мокрой ладони	[['мокрый', {'дат,ед', 'твор,ед', 'род,ед', 'пр,ед'}], ['ладонь', {'дат,ед', 'вин,мн', 'род,ед', 'им,мн', 'пр,ед'}]]
мокрых условиях	[['мокрый', {'род,мн', 'вин,мн', 'пр,мн'}], ['условие', {'пр,мн'}]]
мокрый башмачок	[['мокрый', {'вин,ед', 'им,ед'}], ['башмачок', {'вин,ед', 'им,ед'}]]
мокрых булыжниках	[['мокрый', {'род,мн', 'вин,мн', 'пр,мн'}], ['булыжник', {'пр,мн'}]]
мокрый звук	[['мокрый', {'вин,ед', 'им,ед'}], ['звук', {'вин,ед', 'им,ед'}]]
мокрый мох	[['мокрый', {'вин,ед', 'им,ед'}], ['мох', {'вин,ед', 'им,ед'}]]
мокром булыжнике	[['мокрый', {'пр,ед'}], ['булыжник', {'пр,ед'}]]
мокрую часть	[['мокрый', {'вин,ед'}], ['часть', {'вин,ед', 'им,ед'}]]
мокрое сено	[['мокрый', {'вин,ед', 'им,ед'}], ['сено', {'вин,ед', 'им,ед'}]]
мокрые носы	[['мокрый', {'вин,мн', 'им,мн'}], ['нос', {'вин,мн', 'им,мн'}]]
мокрая губка	[['мокрый', {'им,ед'}], ['губка', {'им,ед'}]]
мокрым полям	[['мокрый', {'твор,ед', 'дат,мн'}], ['поле', {'дат,мн'}]]
мокрому дну	[['мокрый', {'дат,ед'}], ['дно', {'дат,ед'}]]
мокрых ветвей	[['мокрый', {'род,мн', 'вин,мн', 'пр,мн'}], ['ветвь', {'род,мн'}]]
мокрыми деревьями	[['мокрый', {'твор,мн'}], ['дерево', {'твор,мн'}]]
мокрый чулок	[['мокрый', {'вин,ед', 'им,ед'}], ['чулок', {'вин,ед', 'род,мн', 'им,ед'}]]
мокрый суглинок	[['мокрый', {'вин,ед', 'им,ед'}], ['суглинок', {'вин,ед', 'им,ед'}]]
мокром шоссе	[['мокрый', {'пр,ед'}], ['шоссе', {'род,ед', 'пр,ед', 'род,мн', 'твор,ед', 'вин,мн', 'им,мн', 'дат,мн', 'им,ед', 'твор,мн', 'вин,ед', 'пр,мн', 'дат,ед'}]]
мокрые солонцы	[['мокрый', {'вин,мн', 'им,мн'}], ['солонец', {'вин,мн', 'им,мн'}]]
мокрые губы	[['мокрый', {'вин,мн', 'им,мн'}], ['губа', {'вин,мн', 'род,ед', 'им,мн'}]]
мокрой головне	[['мокрый', {'дат,ед', 'твор,ед', 'род,ед', 'пр,ед'}], ['головня', {'дат,ед', 'пр,ед'}]]
мокрые космы	[['мокрый', {'вин,мн', 'им,мн'}], ['космы', {'вин,мн', 'им,мн', 'род,ед'}]]
мокрыми тряпками	[['мокрый', {'твор,мн'}], ['тряпка', {'твор,мн'}]]
мокрой осокой	[['мокрый', {'дат,ед', 'твор,ед', 'род,ед', 'пр,ед'}], ['осока', {'твор,ед'}]]
мокрых тучах	[['мокрый', {'род,мн', 'вин,мн', 'пр,мн'}], ['туча', {'пр,мн'}]]
мокрые рты	[['мокрый', {'вин,мн', 'им,мн'}], ['рот', {'вин,мн', 'им,мн'}]]
мокрых костюмах	[['мокрый', {'род,мн', 'вин,мн', 'пр,мн'}], ['костюм', {'пр,мн'}]]
мокрый круг	[['мокрый', {'вин,ед', 'им,ед'}], ['круг', {'вин,ед', 'им,ед'}]]
мокрой тканью	[['мокрый', {'дат,ед', 'твор,ед', 'род,ед', 'пр,ед'}], ['ткань', {'твор,ед', 'дат,ед'}]]
мокрые полотнища	[['мокрый', {'вин,мн', 'им,мн'}], ['полотнище', {'вин,мн', 'род,ед', 'им,мн'}]]
мокрой простыне	[['мокрый', {'дат,ед', 'твор,ед', 'род,ед', 'пр,ед'}], ['простыня', {'дат,ед', 'пр,ед'}]]
мокрой сиренью	[['мокрый', {'дат,ед', 'твор,ед', 'род,ед', 'пр,ед'}], ['сирень', {'твор,ед'}]]
мокрые годы	[['мокрый', {'вин,мн', 'им,мн'}], ['год', {'вин,мн', 'им,мн'}]]
мокрый парус	[['мокрый', {'вин,ед', 'им,ед'}], ['парус', {'вин,ед', 'им,ед'}]]
мокрой тропинке	[['мокрый', {'дат,ед', 'твор,ед', 'род,ед', 'пр,ед'}], ['тропинка', {'дат,ед', 'пр,ед'}]]
мокрыми портянками	[['мокрый', {'твор,мн'}], ['портянка', {'твор,мн'}]]
мокром иле	[['мокрый', {'пр,ед'}], ['ил', {'пр,ед'}]]
мокрого поля	[['мокрый', {'вин,ед', 'род,ед'}], ['поле', {'род,ед', 'непрош,деепр', 'вин,мн', 'им,мн', 'им,ед', 'вин,ед'}]]
мокрый снег	[['мокрый', {'вин,ед', 'им,ед'}], ['снег', {'вин,ед', 'им,ед'}]]
мокрые облака	[['мокрый', {'вин,мн', 'им,мн'}], ['облако', {'вин,мн', 'род,ед', 'им,мн'}]]
мокрой очистки	[['мокрый', {'дат,ед', 'твор,ед', 'род,ед', 'пр,ед'}], ['очистка', {'вин,мн', 'род,ед', 'им,мн'}]]
мокрых валенок	[['мокрый', {'род,мн', 'вин,мн', 'пр,мн'}], ['валенок', {'вин,ед', 'род,мн', 'им,ед'}]]
мокрый кот	[['мокрый', {'вин,ед', 'им,ед'}], ['кот', {'им,ед'}]]
мокрый шкот	[['мокрый', {'вин,ед', 'им,ед'}], ['шкот', {'вин,ед', 'им,ед'}]]
мокрую ткань	[['мокрый', {'вин,ед'}], ['ткань', {'вин,ед', 'им,ед'}]]
мокрой псиной	[['мокрый', {'дат,ед', 'твор,ед', 'род,ед', 'пр,ед'}], ['псиный=A=пр,ед,полн,жен', {'твор,ед,муж', 'род,ед,полн,жен', 'твор,ед,полн,жен', 'пр,ед,полн,жен', 'дат,ед,полн,жен', 'твор,ед,жен'}]]
мокрую цепь	[['мокрый', {'вин,ед'}], ['цепь', {'вин,ед', 'им,ед'}]]
мокрому делу	[['мокрый', {'дат,ед'}], ['дело', {'дат,ед'}]]
мокрого хлеба	[['мокрый', {'вин,ед', 'род,ед'}], ['хлеб', {'вин,мн', 'род,ед', 'им,мн'}]]
мокрые тарелки	[['мокрый', {'вин,мн', 'им,мн'}], ['тарелка', {'вин,мн', 'род,ед', 'им,мн'}]]
мокрой подстилке	[['мокрый', {'дат,ед', 'твор,ед', 'род,ед', 'пр,ед'}], ['подстилка', {'дат,ед', 'пр,ед'}]]
мокрым лугом	[['мокрый', {'твор,ед', 'дат,мн'}], ['луг', {'твор,ед'}]]
мокрым мохом	[['мокрый', {'твор,ед', 'дат,мн'}], ['мох', {'твор,ед'}]]
мокрый флаг	[['мокрый', {'вин,ед', 'им,ед'}], ['флаг', {'вин,ед', 'им,ед'}]]
мокрой головней	[['мокрый', {'дат,ед', 'твор,ед', 'род,ед', 'пр,ед'}], ['головня', {'род,мн', 'срав', 'твор,ед', 'вин,мн'}]]
мокрый пласт	[['мокрый', {'вин,ед', 'им,ед'}], ['пласт', {'вин,ед', 'им,ед'}]]
мокрая клеенка	[['мокрый', {'им,ед'}], ['клеенка', {'им,ед'}]]
мокрых щек	[['мокрый', {'род,мн', 'вин,мн', 'пр,мн'}], ['щека', {'род,мн'}]]
мокрых облаков	[['мокрый', {'род,мн', 'вин,мн', 'пр,мн'}], ['облако', {'род,мн'}]]
мокрые тучи	[['мокрый', {'вин,мн', 'им,мн'}], ['туча', {'вин,мн', 'род,ед', 'им,мн'}]]
мокрые сумерки	[['мокрый', {'вин,мн', 'им,мн'}], ['сумерки', {'вин,мн', 'им,мн'}]]
мокрая курица	[['мокрый', {'им,ед'}], ['курица', {'им,ед'}]]
мокрого меха	[['мокрый', {'вин,ед', 'род,ед'}], ['мех', {'вин,мн', 'род,ед', 'им,мн'}]]
мокрые были	[['мокрый', {'вин,мн', 'им,мн'}], ['быть=V,нп=прош,мн,изъяв,несов', {'род,ед', 'пр,ед', 'вин,мн', 'им,мн', 'прош,мн,изъяв,несов', 'дат,ед'}]]
мокрыми плечами	[['мокрый', {'твор,мн'}], ['плечо', {'твор,мн'}]]
мокрой темени	[['мокрый', {'дат,ед', 'твор,ед', 'род,ед', 'пр,ед'}], ['темень', {'дат,ед', 'вин,мн', 'род,ед', 'им,мн', 'пр,ед'}]]
мокрой тропе	[['мокрый', {'дат,ед', 'твор,ед', 'род,ед', 'пр,ед'}], ['тропа', {'дат,ед', 'пр,ед'}]]
мокрой аллее	[['мокрый', {'дат,ед', 'твор,ед', 'род,ед', 'пр,ед'}], ['аллея', {'дат,ед', 'пр,ед'}]]
мокрой ладонью	[['мокрый', {'дат,ед', 'твор,ед', 'род,ед', 'пр,ед'}], ['ладонь', {'твор,ед'}]]
мокрым волосам	[['мокрый', {'твор,ед', 'дат,мн'}], ['волос', {'дат,мн'}]]
мокрому полу	[['мокрый', {'дат,ед'}], ['пол', {'', 'пр', 'местн,ед', 'вин,ед', 'дат', 'род', 'твор', 'дат,ед'}]]
мокрому булыжнику	[['мокрый', {'дат,ед'}], ['булыжник', {'дат,ед'}]]
мокрые глыбы	[['мокрый', {'вин,мн', 'им,мн'}], ['глыба', {'вин,мн', 'род,ед', 'им,мн'}]]
мокрых простынях	[['мокрый', {'род,мн', 'вин,мн', 'пр,мн'}], ['простыня', {'пр,мн'}]]
мокрые лица	[['мокрый', {'вин,мн', 'им,мн'}], ['лицо', {'вин,мн', 'род,ед', 'им,мн'}]]
мокрые трусы	[['мокрый', {'вин,мн', 'им,мн'}], ['трусы', {'вин,мн', 'им,мн'}]]
мокрая штукатурка	[['мокрый', {'им,ед'}], ['штукатурка', {'им,ед'}]]
мокрую сигарету	[['мокрый', {'вин,ед'}], ['сигарета', {'вин,ед'}]]
мокрой рубахи	[['мокрый', {'дат,ед', 'твор,ед', 'род,ед', 'пр,ед'}], ['рубаха', {'вин,мн', 'род,ед', 'им,мн'}]]
мокрую дорогу	[['мокрый', {'вин,ед'}], ['дорога', {'вин,ед'}]]
мокрого пылеулавливания	[['мокрый', {'вин,ед', 'род,ед'}], ['пылеулавливание', {'вин,мн', 'род,ед', 'им,мн'}]]
мокрые звезды	[['мокрый', {'вин,мн', 'им,мн'}], ['звезда', {'вин,мн', 'род,ед', 'им,мн'}]]
мокрые руки	[['мокрый', {'вин,мн', 'им,мн'}], ['рука', {'вин,мн', 'род,ед', 'им,мн'}]]
мокрыми опилками	[['мокрый', {'твор,мн'}], ['опилки', {'твор,мн'}]]
мокрое шлепанье	[['мокрый', {'вин,ед', 'им,ед'}], ['шлепанье', {'вин,ед', 'им,ед', 'пр,ед'}]]
мокрым сожжением	[['мокрый', {'твор,ед', 'дат,мн'}], ['сожжение', {'твор,ед'}]]
мокрые онучи	[['мокрый', {'вин,мн', 'им,мн'}], ['онуча', {'вин,мн', 'род,ед', 'им,мн'}]]
мокрая крыса	[['мокрый', {'им,ед'}], ['крыса', {'им,ед'}]]
мокрых деревьях	[['мокрый', {'род,мн', 'вин,мн', 'пр,мн'}], ['дерево', {'пр,мн'}]]
мокрых штанов	[['мокрый', {'род,мн', 'вин,мн', 'пр,мн'}], ['штаны', {'род,мн'}]]
мокрой пыли	[['мокрый', {'дат,ед', 'твор,ед', 'род,ед', 'пр,ед'}], ['пыль', {'род,ед', 'пр,ед', 'ед,пов,2-л', 'вин,мн', 'им,мн', 'дат,ед'}]]
мокрый висок	[['мокрый', {'вин,ед', 'им,ед'}], ['висок', {'вин,ед', 'род,мн', 'им,ед'}]]
мокрой курицей	[['мокрый', {'дат,ед', 'твор,ед', 'род,ед', 'пр,ед'}], ['курица', {'твор,ед'}]]
мокрых участках	[['мокрый', {'род,мн', 'вин,мн', 'пр,мн'}], ['участок', {'пр,мн'}]]
мокрая погода	[['мокрый', {'им,ед'}], ['погода', {'им,ед'}]]
мокрые бока	[['мокрый', {'вин,мн', 'им,мн'}], ['бок', {'вин,мн', 'род,ед', 'им,мн'}]]
мокрые курицы	[['мокрый', {'вин,мн', 'им,мн'}], ['курица', {'род,ед', 'им,мн'}]]
мокрую платформу	[['мокрый', {'вин,ед'}], ['платформа', {'вин,ед'}]]
мокрые стебли	[['мокрый', {'вин,мн', 'им,мн'}], ['стебель', {'вин,мн', 'им,мн'}]]
мокрой головою	[['мокрый', {'дат,ед', 'твор,ед', 'род,ед', 'пр,ед'}], ['голова', {'твор,ед'}]]
мокрым сеном	[['мокрый', {'твор,ед', 'дат,мн'}], ['сено', {'твор,ед'}]]
мокрому железу	[['мокрый', {'дат,ед'}], ['железо', {'вин,ед', 'дат,ед'}]]
мокрому термометрам	[['мокрый', {'дат,ед'}], ['термометр', {'дат,мн'}]]
мокрый куст	[['мокрый', {'вин,ед', 'им,ед'}], ['куст', {'вин,ед', 'им,ед'}]]
мокрые штаны	[['мокрый', {'вин,мн', 'им,мн'}], ['штаны', {'вин,мн', 'им,мн'}]]
мокром платке	[['мокрый', {'пр,ед'}], ['платок', {'пр,ед'}]]
мокрыя деревья	[['мокрый', {'устар,вин', 'устар,им'}], ['дерево', {'вин,мн', 'им,мн'}]]
мокрой скуки	[['мокрый', {'дат,ед', 'твор,ед', 'род,ед', 'пр,ед'}], ['скука', {'вин,мн', 'род,ед', 'им,мн'}]]
мокрую сеть	[['мокрый', {'вин,ед'}], ['сеть', {'вин,ед', 'им,ед'}]]
мокрый май	[['мокрый', {'вин,ед', 'им,ед'}], ['май', {'вин,ед', 'род,мн', 'ед,пов,2-л', 'вин,мн', 'им,ед'}]]
мокрой закладки	[['мокрый', {'дат,ед', 'твор,ед', 'род,ед', 'пр,ед'}], ['закладка', {'вин,мн', 'род,ед', 'им,мн'}]]
мокром обогащении	[['мокрый', {'пр,ед'}], ['обогащение', {'пр,ед'}]]
мокром столбе	[['мокрый', {'пр,ед'}], ['столб', {'пр,ед'}]]
мокрая крупа	[['мокрый', {'им,ед'}], ['крупа', {'род,ед', 'им,ед'}]]
мокрого озоления	[['мокрый', {'вин,ед', 'род,ед'}], ['озоление', {'вин,мн', 'род,ед', 'им,мн'}]]
мокрых типах	[['мокрый', {'род,мн', 'вин,мн', 'пр,мн'}], ['тип', {'пр,мн'}]]
мокрым холстом	[['мокрый', {'твор,ед', 'дат,мн'}], ['холст', {'твор,ед'}]]
мокрые камешки	[['мокрый', {'вин,мн', 'им,мн'}], ['камешек', {'вин,мн', 'им,мн'}]]
мокрый ус	[['мокрый', {'вин,ед', 'им,ед'}], ['ус', {'вин,ед', 'им,ед'}]]
мокрым деревом	[['мокрый', {'твор,ед', 'дат,мн'}], ['дерево', {'твор,ед'}]]
мокрой гнили	[['мокрый', {'дат,ед', 'твор,ед', 'род,ед', 'пр,ед'}], ['гниль', {'прош,мн,изъяв', 'род,ед', 'пр,ед', 'вин,мн', 'им,мн', 'дат,ед'}]]
мокрую косу	[['мокрый', {'вин,ед'}], ['коса', {'вин,ед', 'дат,ед'}]]
мокрого забора	[['мокрый', {'вин,ед', 'род,ед'}], ['забор', {'род,ед'}]]
мокрого песку	[['мокрый', {'вин,ед', 'род,ед'}], ['песок', {'парт,ед', 'дат,ед'}]]
мокрой мешковиной	[['мокрый', {'дат,ед', 'твор,ед', 'род,ед', 'пр,ед'}], ['мешковина', {'твор,ед'}]]
мокрые перчатки	[['мокрый', {'вин,мн', 'им,мн'}], ['перчатка', {'вин,мн', 'род,ед', 'им,мн'}]]
мокрую глину	[['мокрый', {'вин,ед'}], ['глина', {'вин,ед'}]]
мокрой майкой	[['мокрый', {'дат,ед', 'твор,ед', 'род,ед', 'пр,ед'}], ['майка', {'твор,ед'}]]
мокрым лесом	[['мокрый', {'твор,ед', 'дат,мн'}], ['лес', {'', 'твор,ед'}]]
мокрое стекло	[['мокрый', {'вин,ед', 'им,ед'}], ['стекло', {'вин,ед', 'им,ед', 'прош,ед,изъяв,сред,сов'}]]
мокрого воробья	[['мокрый', {'вин,ед', 'род,ед'}], ['воробей', {'вин,ед', 'род,ед'}]]
мокрых ботинок	[['мокрый', {'род,мн', 'вин,мн', 'пр,мн'}], ['ботинок', {'вин,ед', 'род,мн', 'им,ед'}]]
мокрою картошкой	[['мокрый', {'твор,ед'}], ['картошка', {'твор,ед'}]]
мокрых туфлях	[['мокрый', {'род,мн', 'вин,мн', 'пр,мн'}], ['туфля', {'пр,мн'}]]
мокром кулаке	[['мокрый', {'пр,ед'}], ['кулак', {'пр,ед'}]]
мокрые флаги	[['мокрый', {'вин,мн', 'им,мн'}], ['флаг', {'вин,мн', 'им,мн'}]]
мокрые косы	[['мокрый', {'вин,мн', 'им,мн'}], ['коса', {'мн,кр', 'вин,мн', 'род,ед', 'им,мн'}]]
мокрые ватники	[['мокрый', {'вин,мн', 'им,мн'}], ['ватник', {'вин,мн', 'им,мн'}]]
мокрой пылью	[['мокрый', {'дат,ед', 'твор,ед', 'род,ед', 'пр,ед'}], ['пыль', {'твор,ед'}]]
мокрой одеждой	[['мокрый', {'дат,ед', 'твор,ед', 'род,ед', 'пр,ед'}], ['одежда', {'твор,ед'}]]
мокрые пылеуловители	[['мокрый', {'вин,мн', 'им,мн'}], ['пылеуловитель', {'вин,мн', 'им,мн'}]]
мокрыми методами	[['мокрый', {'твор,мн'}], ['метод', {'твор,мн'}]]
мокрый свитер	[['мокрый', {'вин,ед', 'им,ед'}], ['свитер', {'вин,ед', 'им,ед'}]]
мокрых девок	[['мокрый', {'род,мн', 'вин,мн', 'пр,мн'}], ['девка', {'род,мн', 'вин,мн'}]]
мокрую портянку	[['мокрый', {'вин,ед'}], ['портянка', {'вин,ед'}]]
мокрой груди	[['мокрый', {'дат,ед', 'твор,ед', 'род,ед', 'пр,ед'}], ['грудь', {'дат,ед', 'вин,мн', 'род,ед', 'им,мн', 'пр,ед'}]]
мокрою кабинкой	[['мокрый', {'твор,ед'}], ['кабинка', {'твор,ед'}]]
мокрую прядку	[['мокрый', {'вин,ед'}], ['прядка', {'вин,ед'}]]
мокрого сада	[['мокрый', {'вин,ед', 'род,ед'}], ['сад', {'род,ед'}]]
мокрые куртки	[['мокрый', {'вин,мн', 'им,мн'}], ['куртка', {'вин,мн', 'род,ед', 'им,мн'}]]
мокрый процесс	[['мокрый', {'вин,ед', 'им,ед'}], ['процесс', {'вин,ед', 'им,ед'}]]
мокром трикотаже	[['мокрый', {'пр,ед'}], ['трикотаж', {'пр,ед'}]]
мокрых солонцах	[['мокрый', {'род,мн', 'вин,мн', 'пр,мн'}], ['солонец', {'пр,мн'}]]
мокром подвале	[['мокрый', {'пр,ед'}], ['подвал', {'пр,ед'}]]
мокрую обувь	[['мокрый', {'вин,ед'}], ['обувь', {'вин,ед', 'им,ед'}]]
мокрую руку	[['мокрый', {'вин,ед'}], ['рука', {'вин,ед'}]]
мокрой консервации	[['мокрый', {'дат,ед', 'твор,ед', 'род,ед', 'пр,ед'}], ['консервация', {'дат,ед', 'вин,мн', 'род,ед', 'им,мн', 'пр,ед'}]]
мокрую шинель	[['мокрый', {'вин,ед'}], ['шинель', {'вин,ед', 'им,ед'}]]
мокрое яблоко	[['мокрый', {'вин,ед', 'им,ед'}], ['яблоко', {'вин,ед', 'им,ед'}]]
мокрая вьюга	[['мокрый', {'им,ед'}], ['вьюга', {'им,ед'}]]
мокрому лесу	[['мокрый', {'дат,ед'}], ['лес', {'вин,ед', 'парт,ед', 'местн,ед', 'дат,ед'}]]
мокрому подоконнику	[['мокрый', {'дат,ед'}], ['подоконник', {'дат,ед'}]]
мокром ковре	[['мокрый', {'пр,ед'}], ['ковер', {'пр,ед'}]]
мокрых лесах	[['мокрый', {'род,мн', 'вин,мн', 'пр,мн'}], ['лес', {'пр,мн'}]]
мокрую тряпку	[['мокрый', {'вин,ед'}], ['тряпка', {'вин,ед'}]]
мокрого лица	[['мокрый', {'вин,ед', 'род,ед'}], ['лицо', {'вин,мн', 'род,ед', 'им,мн'}]]
мокрым штанам	[['мокрый', {'твор,ед', 'дат,мн'}], ['штаны', {'дат,мн'}]]
мокрому дереву	[['мокрый', {'дат,ед'}], ['дерево', {'дат,ед'}]]
мокрое личико	[['мокрый', {'вин,ед', 'им,ед'}], ['личико', {'вин,ед', 'им,ед'}]]
мокрой березке	[['мокрый', {'дат,ед', 'твор,ед', 'род,ед', 'пр,ед'}], ['березка', {'дат,ед', 'пр,ед'}]]
мокрые пожни	[['мокрый', {'вин,мн', 'им,мн'}], ['пожня', {'вин,мн', 'род,ед', 'им,мн', 'ед,пов,2-л,сов'}]]
мокрой овчиной	[['мокрый', {'дат,ед', 'твор,ед', 'род,ед', 'пр,ед'}], ['овчина', {'твор,ед'}]]
мокрую юбку	[['мокрый', {'вин,ед'}], ['юбка', {'вин,ед'}]]
мокрая конница	[['мокрый', {'им,ед'}], ['конница', {'им,ед'}]]
мокрый подоконник	[['мокрый', {'вин,ед', 'им,ед'}], ['подоконник', {'вин,ед', 'им,ед'}]]
мокрыми вениками	[['мокрый', {'твор,мн'}], ['веник', {'твор,мн'}]]
мокрых скалах	[['мокрый', {'род,мн', 'вин,мн', 'пр,мн'}], ['скала', {'пр,мн'}]]
мокрую шубу	[['мокрый', {'вин,ед'}], ['шуба', {'вин,ед'}]]
мокрых плавках	[['мокрый', {'род,мн', 'вин,мн', 'пр,мн'}], ['плавки', {'пр,мн'}]]
мокрых откосов	[['мокрый', {'род,мн', 'вин,мн', 'пр,мн'}], ['откос', {'род,мн'}]]
мокрому мху	[['мокрый', {'дат,ед'}], ['мох', {'парт,ед', 'местн,ед', 'дат,ед'}]]
мокрый петух	[['мокрый', {'вин,ед', 'им,ед'}], ['петух', {'им,ед'}]]
мокрыми ладонями	[['мокрый', {'твор,мн'}], ['ладонь', {'твор,мн'}]]
мокрыми пылеуловителями	[['мокрый', {'твор,мн'}], ['пылеуловитель', {'твор,мн'}]]
мокрой соломы	[['мокрый', {'дат,ед', 'твор,ед', 'род,ед', 'пр,ед'}], ['солома', {'вин,мн', 'род,ед', 'им,мн'}]]
мокрой крапивы	[['мокрый', {'дат,ед', 'твор,ед', 'род,ед', 'пр,ед'}], ['крапива', {'вин,мн', 'род,ед', 'им,мн'}]]
мокрую пилотку	[['мокрый', {'вин,ед'}], ['пилотка', {'вин,ед'}]]
мокрые простыни	[['мокрый', {'вин,мн', 'им,мн'}], ['простыня', {'вин,мн', 'род,ед', 'им,мн'}]]
мокрыми мордами	[['мокрый', {'твор,мн'}], ['морда', {'твор,мн'}]]
мокрый гравий	[['мокрый', {'вин,ед', 'им,ед'}], ['гравий', {'вин,ед', 'им,ед'}]]
мокрой юбке	[['мокрый', {'дат,ед', 'твор,ед', 'род,ед', 'пр,ед'}], ['юбка', {'дат,ед', 'пр,ед'}]]
мокрым листьям	[['мокрый', {'твор,ед', 'дат,мн'}], ['лист', {'дат,мн'}]]
мокрыми стенами	[['мокрый', {'твор,мн'}], ['стена', {'твор,мн'}]]
мокрым носиком	[['мокрый', {'твор,ед', 'дат,мн'}], ['носик', {'твор,ед'}]]
мокрого стекла	[['мокрый', {'вин,ед', 'род,ед'}], ['стекло', {'прош,ед,изъяв,жен,сов', 'вин,мн', 'род,ед', 'им,мн'}]]
мокром сарафане	[['мокрый', {'пр,ед'}], ['сарафан', {'пр,ед'}]]
мокрые платки	[['мокрый', {'вин,мн', 'им,мн'}], ['платок', {'вин,мн', 'им,мн'}]]
мокром плаще	[['мокрый', {'пр,ед'}], ['плащ', {'пр,ед'}]]
мокрые ботинки	[['мокрый', {'вин,мн', 'им,мн'}], ['ботинок', {'вин,мн', 'им,мн'}]]
мокрого типа	[['мокрый', {'вин,ед', 'род,ед'}], ['тип', {'вин,ед', 'род,ед'}]]
мокрые лошади	[['мокрый', {'вин,мн', 'им,мн'}], ['лошадь', {'дат,ед', 'род,ед', 'им,мн', 'пр,ед'}]]
мокрому тюку	[['мокрый', {'дат,ед'}], ['тюк', {'дат,ед'}]]
мокрый снимок	[['мокрый', {'вин,ед', 'им,ед'}], ['снимок', {'вин,ед', 'род,мн', 'им,ед'}]]
мокрым обработкам	[['мокрый', {'твор,ед', 'дат,мн'}], ['обработка', {'дат,мн'}]]
мокрыми листьями	[['мокрый', {'твор,мн'}], ['лист', {'твор,мн'}]]
мокрой палубе	[['мокрый', {'дат,ед', 'твор,ед', 'род,ед', 'пр,ед'}], ['палуба', {'дат,ед', 'пр,ед'}]]
мокрую ворону	[['мокрый', {'вин,ед'}], ['ворона', {'вин,ед', 'дат,ед'}]]
мокрые способы	[['мокрый', {'вин,мн', 'им,мн'}], ['способ', {'вин,мн', 'им,мн'}]]
мокрый шлепок	[['мокрый', {'вин,ед', 'им,ед'}], ['шлепок', {'вин,ед', 'род,мн', 'им,ед'}]]
мокром месте	[['мокрый', {'пр,ед'}], ['место', {'пр,ед'}]]
мокрый торф	[['мокрый', {'вин,ед', 'им,ед'}], ['торф', {'вин,ед', 'им,ед'}]]
мокрым стуком	[['мокрый', {'твор,ед', 'дат,мн'}], ['стук', {'твор,ед'}]]
мокрыми швабрами	[['мокрый', {'твор,мн'}], ['швабра', {'твор,мн'}]]
мокрых ресницах	[['мокрый', {'род,мн', 'вин,мн', 'пр,мн'}], ['ресница', {'пр,мн'}]]
мокрый чемодан	[['мокрый', {'вин,ед', 'им,ед'}], ['чемодан', {'вин,ед', 'им,ед'}]]
мокрую травку	[['мокрый', {'вин,ед'}], ['травка', {'вин,ед'}]]
мокрые холмы	[['мокрый', {'вин,мн', 'им,мн'}], ['холм', {'вин,мн', 'им,мн'}]]
мокрых ладоней	[['мокрый', {'род,мн', 'вин,мн', 'пр,мн'}], ['ладонь', {'род,мн'}]]
мокрую темень	[['мокрый', {'вин,ед'}], ['темень', {'вин,ед', 'им,ед'}]]
мокрой трав	[['мокрый', {'дат,ед', 'твор,ед', 'род,ед', 'пр,ед'}], ['трава', {'род,мн'}]]
мокрых полотенец	[['мокрый', {'род,мн', 'вин,мн', 'пр,мн'}], ['полотенце', {'род,мн'}]]
мокрых процессах	[['мокрый', {'род,мн', 'вин,мн', 'пр,мн'}], ['процесс', {'пр,мн'}]]
мокрых берез	[['мокрый', {'род,мн', 'вин,мн', 'пр,мн'}], ['береза', {'род,мн'}]]
мокрых образцов	[['мокрый', {'род,мн', 'вин,мн', 'пр,мн'}], ['образец', {'род,мн', 'ед,кр,муж', 'им,ед'}]]
мокрый огонь	[['мокрый', {'вин,ед', 'им,ед'}], ['огонь', {'вин,ед', 'им,ед'}]]
мокром измельчении	[['мокрый', {'пр,ед'}], ['измельчение', {'пр,ед'}]]
мокром картузе	[['мокрый', {'пр,ед'}], ['картуз', {'пр,ед'}]]
мокрым подолом	[['мокрый', {'твор,ед', 'дат,мн'}], ['подол', {'твор,ед'}]]
мокрое утро	[['мокрый', {'вин,ед', 'им,ед'}], ['утро', {'вин,ед', 'им,ед'}]]
мокрый фартук	[['мокрый', {'вин,ед', 'им,ед'}], ['фартук', {'вин,ед', 'им,ед'}]]
мокрыми спинами	[['мокрый', {'твор,мн'}], ['спина', {'твор,мн'}]]
мокрый луг	[['мокрый', {'вин,ед', 'им,ед'}], ['луг', {'вин,ед', 'род,мн', 'им,ед'}]]
мокрые электрофильтры	[['мокрый', {'вин,мн', 'им,мн'}], ['электрофильтр', {'вин,мн', 'им,мн'}]]
мокрую лысину	[['мокрый', {'вин,ед'}], ['лысина', {'вин,ед'}]]
мокрого пиджака	[['мокрый', {'вин,ед', 'род,ед'}], ['пиджак', {'род,ед'}]]
мокрому небу	[['мокрый', {'дат,ед'}], ['небо', {'дат,ед'}]]
мокрым чубом	[['мокрый', {'твор,ед', 'дат,мн'}], ['чуб', {'твор,ед'}]]
мокрая соль	[['мокрый', {'им,ед'}], ['соль', {'род,ед', 'пр,ед', 'род,мн', 'твор,ед', 'вин,мн', 'им,мн', 'дат,мн', 'им,ед', 'твор,мн', 'вин,ед', 'пр,мн', 'дат,ед'}]]
мокрого пальто	[['мокрый', {'вин,ед', 'род,ед'}], ['пальто', {'род,ед', 'пр,ед', 'род,мн', 'твор,ед', 'вин,мн', 'им,мн', 'дат,мн', 'им,ед', 'твор,мн', 'вин,ед', 'пр,мн', 'дат,ед'}]]
мокрым ступеням	[['мокрый', {'твор,ед', 'дат,мн'}], ['ступень', {'дат,мн'}]]
мокрым кустом	[['мокрый', {'твор,ед', 'дат,мн'}], ['куст', {'твор,ед'}]]
мокрые брюки	[['мокрый', {'вин,мн', 'им,мн'}], ['брюки', {'вин,мн', 'им,мн'}]]
мокрая веревка	[['мокрый', {'им,ед'}], ['веревка', {'им,ед'}]]
мокрой мочалкой	[['мокрый', {'дат,ед', 'твор,ед', 'род,ед', 'пр,ед'}], ['мочалка', {'твор,ед'}]]
мокрая брусчатка	[['мокрый', {'им,ед'}], ['брусчатка', {'им,ед'}]]
мокрых валенках	[['мокрый', {'род,мн', 'вин,мн', 'пр,мн'}], ['валенок', {'пр,мн'}]]
мокрый край	[['мокрый', {'вин,ед', 'им,ед'}], ['край', {'вин,ед', 'им,ед'}]]
мокрой рубашки	[['мокрый', {'дат,ед', 'твор,ед', 'род,ед', 'пр,ед'}], ['рубашка', {'вин,мн', 'род,ед', 'им,мн'}]]
мокрой пилотке	[['мокрый', {'дат,ед', 'твор,ед', 'род,ед', 'пр,ед'}], ['пилотка', {'дат,ед', 'пр,ед'}]]
мокрую курицу	[['мокрый', {'вин,ед'}], ['курица', {'вин,ед'}]]
мокрой магн	[['мокрый', {'дат,ед', 'твор,ед', 'род,ед', 'пр,ед'}], ['магн', {'род,мн', 'вин,мн', 'им,ед'}]]
мокрую гимнастерку	[['мокрый', {'вин,ед'}], ['гимнастерка', {'вин,ед'}]]
мокрая шерсть	[['мокрый', {'им,ед'}], ['шерсть', {'вин,ед', 'им,ед'}]]
мокрому асфальту	[['мокрый', {'дат,ед'}], ['асфальт', {'дат,ед'}]]
мокрыми калошами	[['мокрый', {'твор,мн'}], ['калоша', {'твор,мн'}]]
мокрых заборов	[['мокрый', {'род,мн', 'вин,мн', 'пр,мн'}], ['забор', {'род,мн', 'прош,деепр,сов'}]]
мокрого лета	[['мокрый', {'вин,ед', 'род,ед'}], ['лето', {'род,ед', 'им,мн', 'вин,мн'}]]
мокрое полотенце	[['мокрый', {'вин,ед', 'им,ед'}], ['полотенце', {'вин,ед', 'им,ед', 'пр,ед'}]]
мокрого плаща	[['мокрый', {'вин,ед', 'род,ед'}], ['плащ', {'род,ед'}]]
мокрым веткам	[['мокрый', {'твор,ед', 'дат,мн'}], ['ветка', {'дат,мн'}]]
мокрая тундра	[['мокрый', {'им,ед'}], ['тундра', {'им,ед'}]]
мокрым бетоном	[['мокрый', {'твор,ед', 'дат,мн'}], ['бетон', {'твор,ед'}]]
мокрыми соснами	[['мокрый', {'твор,мн'}], ['сосна', {'твор,мн'}]]
мокром откосе	[['мокрый', {'пр,ед'}], ['откос', {'пр,ед'}]]
мокрый лист	[['мокрый', {'вин,ед', 'им,ед'}], ['лист', {'вин,ед', 'им,ед'}]]
мокрыми досками	[['мокрый', {'твор,мн'}], ['доска', {'твор,мн'}]]
мокрую ветошку	[['мокрый', {'вин,ед'}], ['ветошка', {'вин,ед'}]]
мокрую собаку	[['мокрый', {'вин,ед'}], ['собака', {'вин,ед'}]]
мокрый сад	[['мокрый', {'вин,ед', 'им,ед'}], ['сад', {'вин,ед', 'им,ед'}]]
мокрых пальцах	[['мокрый', {'род,мн', 'вин,мн', 'пр,мн'}], ['палец', {'пр,мн'}]]
мокрой курицы	[['мокрый', {'дат,ед', 'твор,ед', 'род,ед', 'пр,ед'}], ['курица', {'род,ед', 'им,мн'}]]
мокрые тени	[['мокрый', {'вин,мн', 'им,мн'}], ['тень', {'род,ед', 'пр,ед', 'ед,пов,2-л', 'вин,мн', 'им,мн', 'дат,ед'}]]
мокрых волосах	[['мокрый', {'род,мн', 'вин,мн', 'пр,мн'}], ['волос', {'пр,мн'}]]
мокрое просеивание	[['мокрый', {'вин,ед', 'им,ед'}], ['просеивание', {'вин,ед', 'им,ед'}]]
мокрый вечер	[['мокрый', {'вин,ед', 'им,ед'}], ['вечер', {'вин,ед', 'им,ед'}]]
мокрые афиши	[['мокрый', {'вин,мн', 'им,мн'}], ['афиша', {'вин,мн', 'род,ед', 'им,мн'}]]
мокрой ветошью	[['мокрый', {'дат,ед', 'твор,ед', 'род,ед', 'пр,ед'}], ['ветошь', {'твор,ед'}]]
мокрых ног	[['мокрый', {'род,мн', 'вин,мн', 'пр,мн'}], ['нога', {'род,мн'}]]
мокрыми ступнями	[['мокрый', {'твор,мн'}], ['ступня', {'твор,мн'}]]
мокрой кисточкой	[['мокрый', {'дат,ед', 'твор,ед', 'род,ед', 'пр,ед'}], ['кисточка', {'твор,ед'}]]
мокрого обеспыливания	[['мокрый', {'вин,ед', 'род,ед'}], ['обеспыливание', {'вин,мн', 'род,ед', 'им,мн'}]]
мокрого рта	[['мокрый', {'вин,ед', 'род,ед'}], ['рот', {'вин,ед', 'род,ед'}]]
мокрых ветвях	[['мокрый', {'род,мн', 'вин,мн', 'пр,мн'}], ['ветвь', {'пр,мн'}]]
мокрой шее	[['мокрый', {'дат,ед', 'твор,ед', 'род,ед', 'пр,ед'}], ['шея', {'дат,ед', 'пр,ед'}]]
мокрую ложку	[['мокрый', {'вин,ед'}], ['ложка', {'вин,ед', 'дат,ед'}]]
мокрому измельчению	[['мокрый', {'дат,ед'}], ['измельчение', {'дат,ед'}]]
мокрой повязкой	[['мокрый', {'дат,ед', 'твор,ед', 'род,ед', 'пр,ед'}], ['повязка', {'твор,ед'}]]
мокрой поверхностью	[['мокрый', {'дат,ед', 'твор,ед', 'род,ед', 'пр,ед'}], ['поверхность', {'твор,ед'}]]
мокрою листвой	[['мокрый', {'твор,ед'}], ['листва', {'твор,ед'}]]
мокрого смешения	[['мокрый', {'вин,ед', 'род,ед'}], ['смешение', {'вин,мн', 'род,ед', 'им,мн'}]]
мокрой ткани	[['мокрый', {'дат,ед', 'твор,ед', 'род,ед', 'пр,ед'}], ['ткань', {'дат,ед', 'вин,мн', 'род,ед', 'им,мн', 'пр,ед'}]]
