влажной лапкой	[['влажный', {'твор,ед', 'пр,ед', 'дат,ед', 'род,ед'}], ['лапка', {'твор,ед'}]]
влажных мхах	[['влажный', {'вин,мн', 'род,мн', 'пр,мн'}], ['мох', {'пр,мн'}]]
влажной низменности	[['влажный', {'твор,ед', 'пр,ед', 'дат,ед', 'род,ед'}], ['низменность', {'им,мн', 'вин,мн', 'пр,ед', 'дат,ед', 'род,ед'}]]
влажная степь	[['влажный', {'им,ед'}], ['степь', {'вин,ед', 'им,ед'}]]
влажным полям	[['влажный', {'твор,ед', 'дат,мн'}], ['поле', {'дат,мн'}]]
влажные солончаки	[['влажный', {'им,мн', 'вин,мн'}], ['солончак', {'им,мн', 'вин,мн'}]]
влажном фильтре	[['влажный', {'пр,ед'}], ['фильтр', {'пр,ед'}]]
влажного сена	[['влажный', {'вин,ед', 'род,ед'}], ['сено', {'им,мн', 'вин,мн', 'род,ед', 'им,ед', 'вин,ед'}]]
влажными образцами	[['влажный', {'твор,мн'}], ['образец', {'твор,мн'}]]
влажные частицы	[['влажный', {'им,мн', 'вин,мн'}], ['частица', {'им,мн', 'вин,мн', 'род,ед'}]]
влажной низине	[['влажный', {'твор,ед', 'пр,ед', 'дат,ед', 'род,ед'}], ['низина', {'пр,ед', 'дат,ед'}]]
влажной земле	[['влажный', {'твор,ед', 'пр,ед', 'дат,ед', 'род,ед'}], ['земля', {'пр,ед', 'дат,ед'}]]
влажный чернозем	[['влажный', {'вин,ед', 'им,ед'}], ['чернозем', {'вин,ед', 'им,ед'}]]
влажные эпохи	[['влажный', {'им,мн', 'вин,мн'}], ['эпоха', {'им,мн', 'вин,мн', 'род,ед'}]]
влажная земля	[['влажный', {'им,ед'}], ['земля', {'им,ед'}]]
влажном тумане	[['влажный', {'пр,ед'}], ['туман', {'пр,ед'}]]
влажные следы	[['влажный', {'им,мн', 'вин,мн'}], ['след', {'им,мн', 'вин,мн'}]]
влажной жаре	[['влажный', {'твор,ед', 'пр,ед', 'дат,ед', 'род,ед'}], ['жар', {'пр,ед', 'дат,ед'}]]
влажным горизонтом	[['влажный', {'твор,ед', 'дат,мн'}], ['горизонт', {'твор,ед'}]]
влажным дыханием	[['влажный', {'твор,ед', 'дат,мн'}], ['дыхание', {'твор,ед'}]]
влажных телах	[['влажный', {'вин,мн', 'род,мн', 'пр,мн'}], ['тело', {'пр,мн'}]]
влажного горения	[['влажный', {'вин,ед', 'род,ед'}], ['горение', {'им,мн', 'вин,мн', 'род,ед'}]]
влажные крыши	[['влажный', {'им,мн', 'вин,мн'}], ['крыша', {'им,мн', 'вин,мн', 'род,ед'}]]
влажная атмосфера	[['влажный', {'им,ед'}], ['атмосфера', {'им,ед'}]]
влажным волосам	[['влажный', {'твор,ед', 'дат,мн'}], ['волос', {'дат,мн'}]]
влажными пальцами	[['влажный', {'твор,мн'}], ['палец', {'твор,мн'}]]
влажную траву	[['влажный', {'вин,ед'}], ['трава', {'вин,ед'}]]
влажной лапки	[['влажный', {'твор,ед', 'пр,ед', 'дат,ед', 'род,ед'}], ['лапка', {'им,мн', 'вин,мн', 'род,ед'}]]
влажные крылья	[['влажный', {'им,мн', 'вин,мн'}], ['крыло', {'им,мн', 'вин,мн'}]]
влажном лесу	[['влажный', {'пр,ед'}], ['лес', {'местн,ед', 'вин,ед', 'дат,ед', 'парт,ед'}]]
влажную зону	[['влажный', {'вин,ед'}], ['зона', {'вин,ед'}]]
влажного холода	[['влажный', {'вин,ед', 'род,ед'}], ['холод', {'им,мн', 'вин,мн', 'род,ед'}]]
влажным прахом	[['влажный', {'твор,ед', 'дат,мн'}], ['прах', {'твор,ед'}]]
влажная гангрена	[['влажный', {'им,ед'}], ['гангрена', {'им,ед'}]]
влажном рте	[['влажный', {'пр,ед'}], ['рот', {'пр,ед'}]]
влажным порошком	[['влажный', {'твор,ед', 'дат,мн'}], ['порошок', {'твор,ед'}]]
влажных кристаллов	[['влажный', {'вин,мн', 'род,мн', 'пр,мн'}], ['кристалл', {'род,мн'}]]
влажный дым	[['влажный', {'вин,ед', 'им,ед'}], ['дым', {'вин,ед', 'им,ед'}]]
влажную тряпку	[['влажный', {'вин,ед'}], ['тряпка', {'вин,ед'}]]
влажными облаками	[['влажный', {'твор,мн'}], ['облако', {'твор,мн'}]]
влажных скал	[['влажный', {'вин,мн', 'род,мн', 'пр,мн'}], ['скала', {'род,мн', 'вин,ед', 'им,ед'}]]
влажными губами	[['влажный', {'твор,мн'}], ['губа', {'твор,мн'}]]
влажных долинах	[['влажный', {'вин,мн', 'род,мн', 'пр,мн'}], ['долина', {'пр,мн'}]]
влажные годы	[['влажный', {'им,мн', 'вин,мн'}], ['год', {'им,мн', 'вин,мн'}]]
влажного фракционирования	[['влажный', {'вин,ед', 'род,ед'}], ['фракционирование', {'им,мн', 'вин,мн', 'род,ед'}]]
влажный год	[['влажный', {'вин,ед', 'им,ед'}], ['год', {'вин,ед', 'им,ед'}]]
влажной массы	[['влажный', {'твор,ед', 'пр,ед', 'дат,ед', 'род,ед'}], ['масса', {'им,мн', 'вин,мн', 'род,ед'}]]
влажных скалах	[['влажный', {'вин,мн', 'род,мн', 'пр,мн'}], ['скала', {'пр,мн'}]]
влажные щеки	[['влажный', {'им,мн', 'вин,мн'}], ['щека', {'им,мн', 'вин,мн', 'род,ед'}]]
влажной рукой	[['влажный', {'твор,ед', 'пр,ед', 'дат,ед', 'род,ед'}], ['рука', {'твор,ед'}]]
влажные грунты	[['влажный', {'им,мн', 'вин,мн'}], ['грунт', {'им,мн', 'вин,мн'}]]
влажных периодов	[['влажный', {'вин,мн', 'род,мн', 'пр,мн'}], ['период', {'род,мн'}]]
влажную голову	[['влажный', {'вин,ед'}], ['голова', {'вин,ед', 'дат,ед'}]]
влажной листве	[['влажный', {'твор,ед', 'пр,ед', 'дат,ед', 'род,ед'}], ['листва', {'пр,ед', 'дат,ед'}]]
влажную смесь	[['влажный', {'вин,ед'}], ['смесь', {'вин,ед', 'им,ед'}]]
влажная шерсть	[['влажный', {'им,ед'}], ['шерсть', {'вин,ед', 'им,ед'}]]
влажном берегу	[['влажный', {'пр,ед'}], ['берег', {'непрош,ед,изъяв,1-л', 'местн,ед', 'дат,ед'}]]
влажная волна	[['влажный', {'им,ед'}], ['волна', {'им,ед'}]]
влажных пород	[['влажный', {'вин,мн', 'род,мн', 'пр,мн'}], ['порода', {'род,мн'}]]
влажного льда	[['влажный', {'вин,ед', 'род,ед'}], ['лед', {'род,ед'}]]
влажным телом	[['влажный', {'твор,ед', 'дат,мн'}], ['тело', {'твор,ед'}]]
влажная трава	[['влажный', {'им,ед'}], ['трава', {'им,ед'}]]
влажным огнем	[['влажный', {'твор,ед', 'дат,мн'}], ['огонь', {'твор,ед'}]]
влажного года	[['влажный', {'вин,ед', 'род,ед'}], ['год', {'им,мн', 'вин,мн', 'род,ед'}]]
влажной духотой	[['влажный', {'твор,ед', 'пр,ед', 'дат,ед', 'род,ед'}], ['духота', {'твор,ед'}]]
влажным лицом	[['влажный', {'твор,ед', 'дат,мн'}], ['лицо', {'твор,ед'}]]
влажном эфире	[['влажный', {'пр,ед'}], ['эфир', {'пр,ед'}]]
влажные плечи	[['влажный', {'им,мн', 'вин,мн'}], ['плечо', {'им,мн', 'вин,мн'}]]
влажными грудами	[['влажный', {'твор,мн'}], ['груда', {'твор,мн'}]]
влажные снежинки	[['влажный', {'им,мн', 'вин,мн'}], ['снежинка', {'им,мн', 'вин,мн', 'род,ед'}]]
влажных отложений	[['влажный', {'вин,мн', 'род,мн', 'пр,мн'}], ['отложение', {'род,мн'}]]
влажной пылью	[['влажный', {'твор,ед', 'пр,ед', 'дат,ед', 'род,ед'}], ['пыль', {'твор,ед'}]]
влажный хруст	[['влажный', {'вин,ед', 'им,ед'}], ['хруст', {'вин,ед', 'им,ед'}]]
влажном асфальте	[['влажный', {'пр,ед'}], ['асфальт', {'пр,ед'}]]
влажного бензола	[['влажный', {'вин,ед', 'род,ед'}], ['бензол', {'род,ед'}]]
влажными соками	[['влажный', {'твор,мн'}], ['сок', {'твор,мн'}]]
влажных солончаках	[['влажный', {'вин,мн', 'род,мн', 'пр,мн'}], ['солончак', {'пр,мн'}]]
влажную повязку	[['влажный', {'вин,ед'}], ['повязка', {'вин,ед'}]]
влажной мешанке	[['влажный', {'твор,ед', 'пр,ед', 'дат,ед', 'род,ед'}], ['мешанка', {'пр,ед', 'дат,ед'}]]
влажные испарения	[['влажный', {'им,мн', 'вин,мн'}], ['испарение', {'им,мн', 'вин,мн', 'род,ед'}]]
влажными ресницами	[['влажный', {'твор,мн'}], ['ресница', {'твор,мн'}]]
влажная мгла	[['влажный', {'им,ед'}], ['мгла', {'им,ед'}]]
влажной шерсти	[['влажный', {'твор,ед', 'пр,ед', 'дат,ед', 'род,ед'}], ['шерсть', {'им,мн', 'вин,мн', 'род,ед', 'пр,ед', 'дат,ед', 'ед,пов,2-л'}]]
влажная стихия	[['влажный', {'им,ед'}], ['стихия', {'им,ед'}]]
влажных странах	[['влажный', {'вин,мн', 'род,мн', 'пр,мн'}], ['страна', {'пр,мн'}]]
влажными волосами	[['влажный', {'твор,мн'}], ['волос', {'твор,мн'}]]
влажному остатку	[['влажный', {'дат,ед'}], ['остаток', {'дат,ед'}]]
влажной зоной	[['влажный', {'твор,ед', 'пр,ед', 'дат,ед', 'род,ед'}], ['зона', {'твор,ед'}]]
влажных стен	[['влажный', {'вин,мн', 'род,мн', 'пр,мн'}], ['стена', {'род,мн', 'вин,ед', 'им,ед'}]]
влажное дыханье	[['влажный', {'вин,ед', 'им,ед'}], ['дыхание', {'вин,ед', 'пр,ед', 'им,ед'}]]
влажным почвам	[['влажный', {'твор,ед', 'дат,мн'}], ['почва', {'дат,мн'}]]
влажных стенок	[['влажный', {'вин,мн', 'род,мн', 'пр,мн'}], ['стенка', {'род,мн'}]]
влажной древесиной	[['влажный', {'твор,ед', 'пр,ед', 'дат,ед', 'род,ед'}], ['древесина', {'твор,ед'}]]
влажного термометра	[['влажный', {'вин,ед', 'род,ед'}], ['термометр', {'род,ед'}]]
влажный прах	[['влажный', {'вин,ед', 'им,ед'}], ['прах', {'вин,ед', 'им,ед'}]]
влажный месяц	[['влажный', {'вин,ед', 'им,ед'}], ['месяц', {'вин,ед', 'им,ед'}]]
влажные языки	[['влажный', {'им,мн', 'вин,мн'}], ['язык', {'им,мн', 'вин,мн'}]]
влажная глина	[['влажный', {'им,ед'}], ['глина', {'им,ед'}]]
влажного мицелия	[['влажный', {'вин,ед', 'род,ед'}], ['мицелий', {'род,ед'}]]
влажных сосняках	[['влажный', {'вин,мн', 'род,мн', 'пр,мн'}], ['сосняк', {'пр,мн'}]]
влажного распева	[['влажный', {'вин,ед', 'род,ед'}], ['распев', {'род,ед'}]]
влажных поймах	[['влажный', {'вин,мн', 'род,мн', 'пр,мн'}], ['пойма', {'пр,мн'}]]
влажную грудь	[['влажный', {'вин,ед'}], ['грудь', {'вин,ед', 'им,ед'}]]
влажной почве	[['влажный', {'твор,ед', 'пр,ед', 'дат,ед', 'род,ед'}], ['почва', {'пр,ед', 'дат,ед'}]]
влажных помещениях	[['влажный', {'вин,мн', 'род,мн', 'пр,мн'}], ['помещение', {'пр,мн'}]]
влажных частиц	[['влажный', {'вин,мн', 'род,мн', 'пр,мн'}], ['частица', {'род,мн'}]]
влажной пыли	[['влажный', {'твор,ед', 'пр,ед', 'дат,ед', 'род,ед'}], ['пыль', {'им,мн', 'вин,мн', 'род,ед', 'пр,ед', 'дат,ед', 'ед,пов,2-л'}]]
влажных объектов	[['влажный', {'вин,мн', 'род,мн', 'пр,мн'}], ['объект', {'род,мн', 'ед,кр,муж'}]]
влажные полотенца	[['влажный', {'им,мн', 'вин,мн'}], ['полотенце', {'им,мн', 'вин,мн', 'род,ед'}]]
влажных глин	[['влажный', {'вин,мн', 'род,мн', 'пр,мн'}], ['глина', {'род,мн'}]]
влажную ручку	[['влажный', {'вин,ед'}], ['ручка', {'вин,ед'}]]
влажного образца	[['влажный', {'вин,ед', 'род,ед'}], ['образец', {'род,ед'}]]
влажной соломы	[['влажный', {'твор,ед', 'пр,ед', 'дат,ед', 'род,ед'}], ['солома', {'им,мн', 'вин,мн', 'род,ед'}]]
влажной грязи	[['влажный', {'твор,ед', 'пр,ед', 'дат,ед', 'род,ед'}], ['грязь', {'им,мн', 'вин,мн', 'пр,ед', 'дат,ед', 'род,ед'}]]
влажных поверхностей	[['влажный', {'вин,мн', 'род,мн', 'пр,мн'}], ['поверхность', {'род,мн'}]]
влажных солей	[['влажный', {'вин,мн', 'род,мн', 'пр,мн'}], ['соль', {'род,мн'}]]
влажные отпечатки	[['влажный', {'им,мн', 'вин,мн'}], ['отпечаток', {'им,мн', 'вин,мн'}]]
влажные кисти	[['влажный', {'им,мн', 'вин,мн'}], ['кисть', {'им,мн', 'вин,мн', 'пр,ед', 'дат,ед', 'род,ед'}]]
влажной буркой	[['влажный', {'твор,ед', 'пр,ед', 'дат,ед', 'род,ед'}], ['бурка', {'твор,ед'}]]
влажной зеленью	[['влажный', {'твор,ед', 'пр,ед', 'дат,ед', 'род,ед'}], ['зелень', {'твор,ед'}]]
влажных зубов	[['влажный', {'вин,мн', 'род,мн', 'пр,мн'}], ['зуб', {'род,мн', 'им,ед'}]]
влажный фильтр	[['влажный', {'вин,ед', 'им,ед'}], ['фильтр', {'вин,ед', 'им,ед'}]]
влажных сев	[['влажный', {'вин,мн', 'род,мн', 'пр,мн'}], ['садиться=V,нп=прош,деепр,сов', {'прош,деепр,сов', 'вин,ед', 'им,ед', 'вин,мн', 'род,мн'}]]
влажным холодком	[['влажный', {'твор,ед', 'дат,мн'}], ['холодок', {'твор,ед'}]]
влажного берега	[['влажный', {'вин,ед', 'род,ед'}], ['берег', {'им,мн', 'вин,мн', 'род,ед'}]]
влажной соломой	[['влажный', {'твор,ед', 'пр,ед', 'дат,ед', 'род,ед'}], ['солома', {'твор,ед'}]]
влажного запаха	[['влажный', {'вин,ед', 'род,ед'}], ['запах', {'род,ед'}]]
влажной постели	[['влажный', {'твор,ед', 'пр,ед', 'дат,ед', 'род,ед'}], ['постель', {'им,мн', 'вин,мн', 'род,ед', 'пр,ед', 'дат,ед', 'ед,пов,2-л,сов'}]]
влажном склоне	[['влажный', {'пр,ед'}], ['склон', {'пр,ед'}]]
влажным полотном	[['влажный', {'твор,ед', 'дат,мн'}], ['полотно', {'твор,ед'}]]
влажной уборки	[['влажный', {'твор,ед', 'пр,ед', 'дат,ед', 'род,ед'}], ['уборка', {'им,мн', 'вин,мн', 'род,ед'}]]
влажного корма	[['влажный', {'вин,ед', 'род,ед'}], ['корм', {'им,мн', 'вин,мн', 'род,ед', 'им,ед'}]]
влажный оттиск	[['влажный', {'вин,ед', 'им,ед'}], ['оттиск', {'вин,ед', 'им,ед'}]]
влажные ягоды	[['влажный', {'им,мн', 'вин,мн'}], ['ягода', {'им,мн', 'вин,мн', 'род,ед'}]]
влажный снежок	[['влажный', {'вин,ед', 'им,ед'}], ['снежок', {'вин,ед', 'им,ед'}]]
влажные кусты	[['влажный', {'им,мн', 'вин,мн'}], ['куст', {'им,мн', 'вин,мн'}]]
влажного дня	[['влажный', {'вин,ед', 'род,ед'}], ['день', {'род,ед'}]]
влажной почвой	[['влажный', {'твор,ед', 'пр,ед', 'дат,ед', 'род,ед'}], ['почва', {'твор,ед'}]]
влажному полу	[['влажный', {'дат,ед'}], ['пол', {'', 'пр', 'род', 'вин,ед', 'твор', 'дат', 'местн,ед', 'дат,ед'}]]
влажными местами	[['влажный', {'твор,мн'}], ['место', {'', 'твор,мн'}]]
влажные звезды	[['влажный', {'им,мн', 'вин,мн'}], ['звезда', {'им,мн', 'вин,мн', 'род,ед'}]]
влажной зелени	[['влажный', {'твор,ед', 'пр,ед', 'дат,ед', 'род,ед'}], ['зелень', {'им,мн', 'вин,мн', 'род,ед', 'пр,ед', 'дат,ед', 'ед,пов,2-л'}]]
влажный носик	[['влажный', {'вин,ед', 'им,ед'}], ['носик', {'вин,ед', 'им,ед'}]]
влажных роз	[['влажный', {'вин,мн', 'род,мн', 'пр,мн'}], ['роза', {'род,мн', 'вин,мн'}]]
влажной адиабаты	[['влажный', {'твор,ед', 'пр,ед', 'дат,ед', 'род,ед'}], ['адиабата', {'им,мн', 'вин,мн', 'род,ед'}]]
влажными испарениями	[['влажный', {'твор,мн'}], ['испарение', {'твор,мн'}]]
влажной хвои	[['влажный', {'твор,ед', 'пр,ед', 'дат,ед', 'род,ед'}], ['хвоя', {'им,мн', 'вин,мн', 'род,ед', 'ед,пов,2-л'}]]
влажной руке	[['влажный', {'твор,ед', 'пр,ед', 'дат,ед', 'род,ед'}], ['рука', {'пр,ед', 'дат,ед'}]]
влажные опилки	[['влажный', {'им,мн', 'вин,мн'}], ['опилки', {'им,мн', 'вин,мн', 'род,ед'}]]
влажный сезон	[['влажный', {'вин,ед', 'им,ед'}], ['сезон', {'вин,ед', 'им,ед'}]]
влажным веником	[['влажный', {'твор,ед', 'дат,мн'}], ['веник', {'твор,ед'}]]
влажную весну	[['влажный', {'вин,ед'}], ['весна', {'вин,ед'}]]
влажных лугах	[['влажный', {'вин,мн', 'род,мн', 'пр,мн'}], ['луг', {'пр,мн'}]]
влажная мешанка	[['влажный', {'им,ед'}], ['мешанка', {'им,ед'}]]
влажнаго климата	[['влажный', {'устар,вин', 'устар,род'}], ['климат', {'род,ед'}]]
влажного тумана	[['влажный', {'вин,ед', 'род,ед'}], ['туман', {'род,ед'}]]
влажных слоев	[['влажный', {'вин,мн', 'род,мн', 'пр,мн'}], ['слой', {'род,мн'}]]
влажных образцах	[['влажный', {'вин,мн', 'род,мн', 'пр,мн'}], ['образец', {'пр,мн'}]]
влажным паром	[['влажный', {'твор,ед', 'дат,мн'}], ['пар', {'вин,ед', 'им,ед', 'твор,ед'}]]
влажных солончаков	[['влажный', {'вин,мн', 'род,мн', 'пр,мн'}], ['солончак', {'род,мн', 'ед,кр,муж'}]]
влажная супесь	[['влажный', {'им,ед'}], ['супесь', {'вин,ед', 'им,ед'}]]
влажную мглу	[['влажный', {'вин,ед'}], ['мгла', {'вин,ед'}]]
влажный лик	[['влажный', {'вин,ед', 'им,ед'}], ['лик', {'вин,ед', 'им,ед', 'вин,мн', 'род,мн'}]]
влажными полотенцами	[['влажный', {'твор,мн'}], ['полотенце', {'твор,мн'}]]
влажные мешанки	[['влажный', {'им,мн', 'вин,мн'}], ['мешанка', {'им,мн', 'вин,мн', 'род,ед'}]]
влажною рукой	[['влажный', {'твор,ед'}], ['рука', {'твор,ед'}]]
влажное серебро	[['влажный', {'вин,ед', 'им,ед'}], ['серебро', {'вин,ед', 'им,ед'}]]
влажных ущелий	[['влажный', {'вин,мн', 'род,мн', 'пр,мн'}], ['ущелие', {'род,мн'}]]
влажное дерево	[['влажный', {'вин,ед', 'им,ед'}], ['дерево', {'вин,ед', 'им,ед'}]]
влажный термометр	[['влажный', {'вин,ед', 'им,ед'}], ['термометр', {'вин,ед', 'им,ед'}]]
влажных уст	[['влажный', {'вин,мн', 'род,мн', 'пр,мн'}], ['уста', {'род,мн'}]]
влажным дном	[['влажный', {'твор,ед', 'дат,мн'}], ['дно', {'твор,ед'}]]
влажным щекам	[['влажный', {'твор,ед', 'дат,мн'}], ['щека', {'дат,мн'}]]
влажные руки	[['влажный', {'им,мн', 'вин,мн'}], ['рука', {'им,мн', 'вин,мн', 'род,ед'}]]
влажных звезд	[['влажный', {'вин,мн', 'род,мн', 'пр,мн'}], ['звезда', {'род,мн', 'вин,мн'}]]
влажной мешанкой	[['влажный', {'твор,ед', 'пр,ед', 'дат,ед', 'род,ед'}], ['мешанка', {'твор,ед'}]]
влажный воздухъ	[['влажный', {'вин,ед', 'им,ед'}], ['воздух', {'вин,ед', 'им,ед'}]]
влажна ночь	[['влажный', {'ед,кр'}], ['ночь', {'вин,ед', 'им,ед'}]]
влажная рука	[['влажный', {'им,ед'}], ['рука', {'им,ед'}]]
влажное время	[['влажный', {'вин,ед', 'им,ед'}], ['время', {'вин,ед', 'им,ед'}]]
влажной темнотой	[['влажный', {'твор,ед', 'пр,ед', 'дат,ед', 'род,ед'}], ['темнота', {'твор,ед'}]]
влажным деревом	[['влажный', {'твор,ед', 'дат,мн'}], ['дерево', {'твор,ед'}]]
влажному рту	[['влажный', {'дат,ед'}], ['рот', {'местн,ед', 'дат,ед'}]]
влажные леса	[['влажный', {'им,мн', 'вин,мн'}], ['лес', {'им,мн', 'вин,мн', 'род,ед', 'им,ед'}]]
влажным покровом	[['влажный', {'твор,ед', 'дат,мн'}], ['покров', {'твор,ед'}]]
влажными ноздрями	[['влажный', {'твор,мн'}], ['ноздря', {'твор,мн'}]]
влажных зарослях	[['влажный', {'вин,мн', 'род,мн', 'пр,мн'}], ['заросль', {'пр,мн'}]]
влажного веса	[['влажный', {'вин,ед', 'род,ед'}], ['вес', {'им,мн', 'вин,мн', 'род,ед'}]]
влажный хрип	[['влажный', {'вин,ед', 'им,ед'}], ['хрип', {'прош,ед,изъяв,муж', 'вин,ед', 'им,ед'}]]
влажных н	[['влажный', {'вин,мн', 'род,мн', 'пр,мн'}], ['н', {'вин,ед', 'дат,мн', 'им,мн', 'вин,мн', 'твор,мн', 'им,ед', 'пр,мн', 'твор,ед', 'род,мн', 'род,ед', 'дат,ед', 'пр,ед'}]]
влажным хрипом	[['влажный', {'твор,ед', 'дат,мн'}], ['хрип', {'твор,ед'}]]
влажные горизонты	[['влажный', {'им,мн', 'вин,мн'}], ['горизонт', {'им,мн', 'вин,мн'}]]
влажный тип	[['влажный', {'вин,ед', 'им,ед'}], ['тип', {'вин,ед', 'им,ед'}]]
влажный сезоны	[['влажный', {'вин,ед', 'им,ед'}], ['сезон', {'им,мн', 'вин,мн'}]]
влажными веками	[['влажный', {'твор,мн'}], ['век', {'твор,мн'}]]
влажном кислороде	[['влажный', {'пр,ед'}], ['кислород', {'пр,ед'}]]
влажной тишине	[['влажный', {'твор,ед', 'пр,ед', 'дат,ед', 'род,ед'}], ['тишина', {'пр,ед', 'дат,ед'}]]
влажные струны	[['влажный', {'им,мн', 'вин,мн'}], ['струна', {'им,мн', 'вин,мн', 'род,ед'}]]
влажного пояса	[['влажный', {'вин,ед', 'род,ед'}], ['пояс', {'им,мн', 'вин,мн', 'род,ед'}]]
влажных местах	[['влажный', {'вин,мн', 'род,мн', 'пр,мн'}], ['место', {'пр,мн'}]]
влажных горизонтах	[['влажный', {'вин,мн', 'род,мн', 'пр,мн'}], ['горизонт', {'пр,мн'}]]
влажный сумрак	[['влажный', {'вин,ед', 'им,ед'}], ['сумрак', {'вин,ед', 'им,ед'}]]
влажной дезинфекции	[['влажный', {'твор,ед', 'пр,ед', 'дат,ед', 'род,ед'}], ['дезинфекция', {'им,мн', 'вин,мн', 'пр,ед', 'дат,ед', 'род,ед'}]]
влажный день	[['влажный', {'вин,ед', 'им,ед'}], ['день', {'вин,ед', 'им,ед', 'ед,пов,2-л,сов'}]]
влажные ночи	[['влажный', {'им,мн', 'вин,мн'}], ['ночь', {'им,мн', 'вин,мн', 'род,ед', 'местн,ед', 'пр,ед', 'дат,ед'}]]
влажному полю	[['влажный', {'дат,ед'}], ['поле', {'непрош,ед,изъяв,1-л', 'вин,ед', 'дат,ед'}]]
влажного носа	[['влажный', {'вин,ед', 'род,ед'}], ['нос', {'род,ед'}]]
влажными годами	[['влажный', {'твор,мн'}], ['год', {'', 'твор,мн'}]]
влажным небом	[['влажный', {'твор,ед', 'дат,мн'}], ['небо', {'твор,ед'}]]
влажных ноздрей	[['влажный', {'вин,мн', 'род,мн', 'пр,мн'}], ['ноздря', {'род,мн', 'твор,ед'}]]
влажную дымку	[['влажный', {'вин,ед'}], ['дымка', {'вин,ед', 'дат,ед', 'парт,ед'}]]
влажных склонах	[['влажный', {'вин,мн', 'род,мн', 'пр,мн'}], ['склон', {'пр,мн'}]]
влажных дубрав	[['влажный', {'вин,мн', 'род,мн', 'пр,мн'}], ['дубрава', {'род,мн'}]]
влажный край	[['влажный', {'вин,ед', 'им,ед'}], ['край', {'вин,ед', 'им,ед'}]]
влажному термометру	[['влажный', {'дат,ед'}], ['термометр', {'дат,ед'}]]
влажной их	[['влажный', {'твор,ед', 'пр,ед', 'дат,ед', 'род,ед'}], ['они=SPRO,мн=вин', {'им,ед,муж', 'род,мн,сред', 'дат,ед,муж', 'дат,ед,сред', 'вин,ед,жен', 'пр,мн', 'вин,мн,од', 'род,мн', 'им,ед,сред', 'вин,мн,сред', 'им,ед,жен', 'вин,ед,муж', 'твор,ед,жен', 'дат,мн,муж', 'пр,ед,жен', 'вин,ед,муж,неод', 'вин,мн,муж', 'вин,мн,неод', 'твор,ед,муж', 'дат,мн,сред', 'им,мн', 'пр,мн,сред', 'твор,мн', 'дат,ед,жен', 'пр,мн,муж', 'род,ед,жен', 'твор,ед,сред', 'вин,ед,сред', 'род,ед,муж', 'дат,мн', 'вин,мн', 'род,ед,сред', 'вин,ед,муж,од', 'пр,ед,муж', 'пр,ед,сред', 'им,мн,сред', 'твор,мн,сред'}]]
влажное пятнышко	[['влажный', {'вин,ед', 'им,ед'}], ['пятнышко', {'вин,ед', 'им,ед'}]]
влажной частицы	[['влажный', {'твор,ед', 'пр,ед', 'дат,ед', 'род,ед'}], ['частица', {'им,мн', 'вин,мн', 'род,ед'}]]
влажная конвекция	[['влажный', {'им,ед'}], ['конвекция', {'им,ед'}]]
влажных щек	[['влажный', {'вин,мн', 'род,мн', 'пр,мн'}], ['щека', {'род,мн'}]]
влажной обработки	[['влажный', {'твор,ед', 'пр,ед', 'дат,ед', 'род,ед'}], ['обработка', {'им,мн', 'вин,мн', 'род,ед'}]]
влажный образец	[['влажный', {'вин,ед', 'им,ед'}], ['образец', {'вин,ед', 'им,ед'}]]
влажную почву	[['влажный', {'вин,ед'}], ['почва', {'вин,ед'}]]
влажный хлеб	[['влажный', {'вин,ед', 'им,ед'}], ['хлеб', {'вин,ед', 'им,ед'}]]
влажными ладони	[['влажный', {'твор,мн'}], ['ладонь', {'им,мн', 'вин,мн', 'пр,ед', 'дат,ед', 'род,ед'}]]
влажном состоянии	[['влажный', {'пр,ед'}], ['состояние', {'пр,ед'}]]
влажном поясе	[['влажный', {'пр,ед'}], ['пояс', {'пр,ед'}]]
влажные обертывания	[['влажный', {'им,мн', 'вин,мн'}], ['обертывание', {'им,мн', 'вин,мн', 'род,ед'}]]
влажных туманов	[['влажный', {'вин,мн', 'род,мн', 'пр,мн'}], ['туман', {'род,мн', 'им,ед'}]]
влажными зубами	[['влажный', {'твор,мн'}], ['зуб', {'твор,мн'}]]
влажному осадку	[['влажный', {'дат,ед'}], ['осадка', {'вин,ед', 'дат,ед'}]]
влажный характер	[['влажный', {'вин,ед', 'им,ед'}], ['характер', {'вин,ед', 'им,ед'}]]
влажные звуки	[['влажный', {'им,мн', 'вин,мн'}], ['звук', {'им,мн', 'вин,мн'}]]
влажные запахи	[['влажный', {'им,мн', 'вин,мн'}], ['запах', {'им,мн', 'вин,мн'}]]
влажный плащ	[['влажный', {'вин,ед', 'им,ед'}], ['плащ', {'вин,ед', 'им,ед'}]]
влажными весной	[['влажный', {'твор,мн'}], ['весна', {'', 'твор,ед'}]]
влажных песках	[['влажный', {'вин,мн', 'род,мн', 'пр,мн'}], ['песок', {'пр,мн'}]]
влажный режим	[['влажный', {'вин,ед', 'им,ед'}], ['режим', {'вин,ед', 'им,ед'}]]
влажных высокогорьях	[['влажный', {'вин,мн', 'род,мн', 'пр,мн'}], ['высокогорье', {'пр,мн'}]]
влажных берегах	[['влажный', {'вин,мн', 'род,мн', 'пр,мн'}], ['берег', {'пр,мн'}]]
влажными красками	[['влажный', {'твор,мн'}], ['краска', {'твор,мн'}]]
влажной глине	[['влажный', {'твор,ед', 'пр,ед', 'дат,ед', 'род,ед'}], ['глина', {'пр,ед', 'дат,ед'}]]
влажная зона	[['влажный', {'им,ед'}], ['зона', {'им,ед'}]]
влажные зубы	[['влажный', {'им,мн', 'вин,мн'}], ['зуб', {'им,мн', 'вин,мн'}]]
влажного листа	[['влажный', {'вин,ед', 'род,ед'}], ['лист', {'род,ед'}]]
влажные зимы	[['влажный', {'им,мн', 'вин,мн'}], ['зима', {'им,мн', 'вин,мн', 'род,ед'}]]
влажной волной	[['влажный', {'твор,ед', 'пр,ед', 'дат,ед', 'род,ед'}], ['волна', {'твор,ед'}]]
влажную камеру	[['влажный', {'вин,ед'}], ['камера', {'вин,ед'}]]
влажную вату	[['влажный', {'вин,ед'}], ['вата', {'вин,ед', 'дат,ед'}]]
влажным снегом	[['влажный', {'твор,ед', 'дат,мн'}], ['снег', {'твор,ед'}]]
влажных луговинах	[['влажный', {'вин,мн', 'род,мн', 'пр,мн'}], ['луговина', {'пр,мн'}]]
влажных лужайках	[['влажный', {'вин,мн', 'род,мн', 'пр,мн'}], ['лужайка', {'пр,мн'}]]
влажными биотопами	[['влажный', {'твор,мн'}], ['биотоп', {'твор,мн'}]]
влажной неустойчивости	[['влажный', {'твор,ед', 'пр,ед', 'дат,ед', 'род,ед'}], ['неустойчивость', {'им,мн', 'вин,мн', 'пр,ед', 'дат,ед', 'род,ед'}]]
влажных испарений	[['влажный', {'вин,мн', 'род,мн', 'пр,мн'}], ['испарение', {'род,мн'}]]
влажным методом	[['влажный', {'твор,ед', 'дат,мн'}], ['метод', {'твор,ед'}]]
влажная вата	[['влажный', {'им,ед'}], ['вата', {'вин,ед', 'им,ед', 'род,ед'}]]
влажная солома	[['влажный', {'им,ед'}], ['солома', {'им,ед'}]]
влажную ткань	[['влажный', {'вин,ед'}], ['ткань', {'вин,ед', 'им,ед'}]]
влажных листьях	[['влажный', {'вин,мн', 'род,мн', 'пр,мн'}], ['лист', {'пр,мн'}]]
влажные ноздри	[['влажный', {'им,мн', 'вин,мн'}], ['ноздря', {'им,мн', 'вин,мн', 'род,ед'}]]
влажных месяцев	[['влажный', {'вин,мн', 'род,мн', 'пр,мн'}], ['месяц', {'род,мн'}]]
влажной зимы	[['влажный', {'твор,ед', 'пр,ед', 'дат,ед', 'род,ед'}], ['зима', {'им,мн', 'вин,мн', 'род,ед'}]]
влажного времени	[['влажный', {'вин,ед', 'род,ед'}], ['время', {'ед,пов,2-л', 'пр,ед', 'дат,ед', 'род,ед'}]]
влажный комочек	[['влажный', {'вин,ед', 'им,ед'}], ['комочек', {'вин,ед', 'им,ед'}]]
влажною землею	[['влажный', {'твор,ед'}], ['земля', {'твор,ед'}]]
влажный волосъ	[['влажный', {'вин,ед', 'им,ед'}], ['волос', {'вин,ед', 'род,мн', 'им,ед'}]]
влажной листвы	[['влажный', {'твор,ед', 'пр,ед', 'дат,ед', 'род,ед'}], ['листва', {'род,ед'}]]
влажной глины	[['влажный', {'твор,ед', 'пр,ед', 'дат,ед', 'род,ед'}], ['глина', {'им,мн', 'вин,мн', 'род,ед'}]]
влажными носами	[['влажный', {'твор,мн'}], ['нос', {'твор,мн'}]]
влажной кожи	[['влажный', {'твор,ед', 'пр,ед', 'дат,ед', 'род,ед'}], ['кожа', {'им,мн', 'вин,мн', 'род,ед'}]]
влажную постель	[['влажный', {'вин,ед'}], ['постель', {'вин,ед', 'им,ед'}]]
влажной темноты	[['влажный', {'твор,ед', 'пр,ед', 'дат,ед', 'род,ед'}], ['темнота', {'род,ед'}]]
влажных глаз	[['влажный', {'вин,мн', 'род,мн', 'пр,мн'}], ['глаз', {'вин,ед', 'род,мн', 'им,ед'}]]
влажным запахом	[['влажный', {'твор,ед', 'дат,мн'}], ['запах', {'твор,ед'}]]
влажных материалов	[['влажный', {'вин,мн', 'род,мн', 'пр,мн'}], ['материал', {'род,мн'}]]
влажные ущелья	[['влажный', {'им,мн', 'вин,мн'}], ['ущелие', {'им,мн', 'вин,мн', 'род,ед'}]]
влажными периодами	[['влажный', {'твор,мн'}], ['период', {'твор,мн'}]]
влажный камень	[['влажный', {'вин,ед', 'им,ед'}], ['камень', {'вин,ед', 'им,ед'}]]
влажные сезоны	[['влажный', {'им,мн', 'вин,мн'}], ['сезон', {'им,мн', 'вин,мн'}]]
влажной вате	[['влажный', {'твор,ед', 'пр,ед', 'дат,ед', 'род,ед'}], ['вата', {'пр,ед', 'дат,ед'}]]
влажных мест	[['влажный', {'вин,мн', 'род,мн', 'пр,мн'}], ['место', {'род,мн'}]]
влажной простыней	[['влажный', {'твор,ед', 'пр,ед', 'дат,ед', 'род,ед'}], ['простыня', {'род,мн', 'твор,ед'}]]
влажные ладони	[['влажный', {'им,мн', 'вин,мн'}], ['ладонь', {'им,мн', 'вин,мн', 'пр,ед', 'дат,ед', 'род,ед'}]]
влажный хлопок	[['влажный', {'вин,ед', 'им,ед'}], ['хлопок', {'вин,ед', 'им,ед'}]]
влажным лугам	[['влажный', {'твор,ед', 'дат,мн'}], ['луг', {'дат,мн'}]]
влажным зноем	[['влажный', {'твор,ед', 'дат,мн'}], ['зной', {'твор,ед'}]]
влажные стации	[['влажный', {'им,мн', 'вин,мн'}], ['стация', {'им,мн', 'вин,мн', 'пр,ед', 'дат,ед', 'род,ед'}]]
влажная пыль	[['влажный', {'им,ед'}], ['пыль', {'вин,ед', 'им,ед'}]]
влажной местности	[['влажный', {'твор,ед', 'пр,ед', 'дат,ед', 'род,ед'}], ['местность', {'им,мн', 'вин,мн', 'пр,ед', 'дат,ед', 'род,ед'}]]
влажной теплоты	[['влажный', {'твор,ед', 'пр,ед', 'дат,ед', 'род,ед'}], ['теплота', {'род,ед'}]]
влажных почв	[['влажный', {'вин,мн', 'род,мн', 'пр,мн'}], ['почва', {'род,мн'}]]
влажные листы	[['влажный', {'им,мн', 'вин,мн'}], ['лист', {'им,мн', 'вин,мн'}]]
влажных пальцев	[['влажный', {'вин,мн', 'род,мн', 'пр,мн'}], ['палец', {'род,мн', 'им,ед'}]]
влажном зерне	[['влажный', {'пр,ед'}], ['зерно', {'пр,ед'}]]
влажными мешанками	[['влажный', {'твор,мн'}], ['мешанка', {'твор,мн'}]]
влажных клеток	[['влажный', {'вин,мн', 'род,мн', 'пр,мн'}], ['клетка', {'род,мн'}]]
влажной красоте	[['влажный', {'твор,ед', 'пр,ед', 'дат,ед', 'род,ед'}], ['красота', {'пр,ед', 'дат,ед'}]]
влажная пленка	[['влажный', {'им,ед'}], ['пленка', {'им,ед'}]]
влажных джунглях	[['влажный', {'вин,мн', 'род,мн', 'пр,мн'}], ['джунгли', {'пр,мн'}]]
влажным периодом	[['влажный', {'твор,ед', 'дат,мн'}], ['период', {'твор,ед'}]]
влажной кукурузы	[['влажный', {'твор,ед', 'пр,ед', 'дат,ед', 'род,ед'}], ['кукуруза', {'им,мн', 'вин,мн', 'род,ед'}]]
влажных зон	[['влажный', {'вин,мн', 'род,мн', 'пр,мн'}], ['зона', {'род,мн'}]]
влажный злак	[['влажный', {'вин,ед', 'им,ед'}], ['злак', {'вин,ед', 'им,ед'}]]
влажным ртом	[['влажный', {'твор,ед', 'дат,мн'}], ['рот', {'твор,ед'}]]
влажный поцелуй	[['влажный', {'вин,ед', 'им,ед'}], ['поцелуй', {'вин,ед', 'им,ед', 'ед,пов,2-л'}]]
влажная ткань	[['влажный', {'им,ед'}], ['ткань', {'вин,ед', 'им,ед'}]]
влажные его	[['влажный', {'им,мн', 'вин,мн'}], ['он=SPRO,ед,3-л,муж=вин', {'им,ед,муж', 'род,мн,сред', 'дат,ед,муж', 'дат,ед,сред', 'вин,ед,жен', 'пр,мн', 'вин,мн,од', 'род,мн', 'им,ед,сред', 'вин,ед', 'вин,мн,сред', 'им,ед,жен', 'вин,ед,муж', 'твор,ед,жен', 'дат,мн,муж', 'пр,ед,жен', 'вин,ед,муж,неод', 'вин,мн,муж', 'вин,мн,неод', 'твор,ед,муж', 'дат,мн,сред', 'им,мн', 'пр,мн,сред', 'твор,мн', 'дат,ед,жен', 'пр,мн,муж', 'род,ед,жен', 'твор,ед,сред', 'вин,ед,сред', 'род,ед,муж', 'дат,мн', 'род,ед,сред', 'вин,ед,муж,од', 'пр,ед,муж', 'пр,ед,сред', 'им,мн,сред', 'род,ед', 'твор,мн,сред'}]]
влажного луга	[['влажный', {'вин,ед', 'род,ед'}], ['луг', {'им,мн', 'вин,мн', 'род,ед', 'им,ед'}]]
влажные салфетки	[['влажный', {'им,мн', 'вин,мн'}], ['салфетка', {'им,мн', 'вин,мн', 'род,ед'}]]
влажными участками	[['влажный', {'твор,мн'}], ['участок', {'твор,мн'}]]
влажная дымка	[['влажный', {'им,ед'}], ['дымок', {'род,ед', 'им,ед'}]]
влажная полоска	[['влажный', {'им,ед'}], ['полоска', {'им,ед'}]]
влажной фазе	[['влажный', {'твор,ед', 'пр,ед', 'дат,ед', 'род,ед'}], ['фаза', {'пр,ед', 'дат,ед'}]]
влажный суглинок	[['влажный', {'вин,ед', 'им,ед'}], ['суглинок', {'вин,ед', 'им,ед'}]]
влажном водяном	[['влажный', {'пр,ед'}], ['водяной=A=пр,ед,полн,муж', {'пр,ед', 'пр,ед,полн,сред', 'пр,ед,полн,муж'}]]
влажной пищи	[['влажный', {'твор,ед', 'пр,ед', 'дат,ед', 'род,ед'}], ['пища', {'им,мн', 'вин,мн', 'род,ед', 'ед,пов,2-л'}]]
влажной древесины	[['влажный', {'твор,ед', 'пр,ед', 'дат,ед', 'род,ед'}], ['древесина', {'им,мн', 'вин,мн', 'род,ед'}]]
влажного слоя	[['влажный', {'вин,ед', 'род,ед'}], ['слой', {'непрош,деепр', 'род,ед'}]]
влажного разнотравья	[['влажный', {'вин,ед', 'род,ед'}], ['разнотравье', {'им,мн', 'вин,мн', 'род,ед'}]]
влажным лесам	[['влажный', {'твор,ед', 'дат,мн'}], ['лес', {'дат,мн'}]]
влажных газах	[['влажный', {'вин,мн', 'род,мн', 'пр,мн'}], ['газ', {'пр,мн'}]]
влажном климате	[['влажный', {'пр,ед'}], ['климат', {'пр,ед'}]]
влажном пространстве	[['влажный', {'пр,ед'}], ['пространство', {'пр,ед'}]]
влажного сырья	[['влажный', {'вин,ед', 'род,ед'}], ['сырье', {'род,ед'}]]
влажным бельем	[['влажный', {'твор,ед', 'дат,мн'}], ['белье', {'твор,ед'}]]
влажную бороду	[['влажный', {'вин,ед'}], ['борода', {'вин,ед'}]]
влажную атмосферу	[['влажный', {'вин,ед'}], ['атмосфера', {'вин,ед'}]]
влажной конвекции	[['влажный', {'твор,ед', 'пр,ед', 'дат,ед', 'род,ед'}], ['конвекция', {'им,мн', 'вин,мн', 'пр,ед', 'дат,ед', 'род,ед'}]]
влажной дорожке	[['влажный', {'твор,ед', 'пр,ед', 'дат,ед', 'род,ед'}], ['дорожка', {'пр,ед', 'дат,ед'}]]
влажной жарой	[['влажный', {'твор,ед', 'пр,ед', 'дат,ед', 'род,ед'}], ['жара', {'твор,ед'}]]
влажной губкой	[['влажный', {'твор,ед', 'пр,ед', 'дат,ед', 'род,ед'}], ['губка', {'твор,ед'}]]
влажные комки	[['влажный', {'им,мн', 'вин,мн'}], ['комок', {'им,мн', 'вин,мн'}]]
влажного протравливания	[['влажный', {'вин,ед', 'род,ед'}], ['протравливание', {'им,мн', 'вин,мн', 'род,ед'}]]
влажной свежести	[['влажный', {'твор,ед', 'пр,ед', 'дат,ед', 'род,ед'}], ['свежесть', {'им,мн', 'вин,мн', 'пр,ед', 'дат,ед', 'род,ед'}]]
влажной хвоей	[['влажный', {'твор,ед', 'пр,ед', 'дат,ед', 'род,ед'}], ['хвоя', {'твор,ед'}]]
влажным поверхностям	[['влажный', {'твор,ед', 'дат,мн'}], ['поверхность', {'дат,мн'}]]
влажных корней	[['влажный', {'вин,мн', 'род,мн', 'пр,мн'}], ['корень', {'род,мн', 'им,ед'}]]
влажнее почва	[['влажный', {'срав'}], ['почва', {'им,ед'}]]
влажной зоне	[['влажный', {'твор,ед', 'пр,ед', 'дат,ед', 'род,ед'}], ['зона', {'пр,ед', 'дат,ед'}]]
влажный остаток	[['влажный', {'вин,ед', 'им,ед'}], ['остаток', {'вин,ед', 'им,ед'}]]
влажного препарата	[['влажный', {'вин,ед', 'род,ед'}], ['препарат', {'род,ед'}]]
влажном районе	[['влажный', {'пр,ед'}], ['район', {'пр,ед'}]]
влажных климатах	[['влажный', {'вин,мн', 'род,мн', 'пр,мн'}], ['климат', {'пр,мн'}]]
влажных типах	[['влажный', {'вин,мн', 'род,мн', 'пр,мн'}], ['тип', {'пр,мн'}]]
влажным лесом	[['влажный', {'твор,ед', 'дат,мн'}], ['лес', {'', 'твор,ед'}]]
влажный пар	[['влажный', {'вин,ед', 'им,ед'}], ['пар', {'вин,ед', 'им,ед', 'род,мн'}]]
влажных долин	[['влажный', {'вин,мн', 'род,мн', 'пр,мн'}], ['долина', {'род,мн', 'им,ед'}]]
влажные степи	[['влажный', {'им,мн', 'вин,мн'}], ['степь', {'им,мн', 'вин,мн', 'пр,ед', 'дат,ед', 'род,ед'}]]
влажных ветров	[['влажный', {'вин,мн', 'род,мн', 'пр,мн'}], ['ветер', {'род,мн', 'им,ед'}]]
влажною прохладой	[['влажный', {'твор,ед'}], ['прохлада', {'твор,ед'}]]
влажной земли	[['влажный', {'твор,ед', 'пр,ед', 'дат,ед', 'род,ед'}], ['земля', {'им,мн', 'вин,мн', 'род,ед'}]]
влажные зерна	[['влажный', {'им,мн', 'вин,мн'}], ['зерно', {'им,мн', 'вин,мн', 'род,ед'}]]
влажной мостовой	[['влажный', {'твор,ед', 'пр,ед', 'дат,ед', 'род,ед'}], ['мостовая', {'пр,ед,полн,жен', 'вин,ед,полн,муж,неод', 'твор,ед,полн,жен', 'род,ед,полн,жен', 'им,ед', 'дат,ед,полн,жен', 'твор,ед', 'дат,ед,жен', 'твор,ед,жен', 'род,ед', 'род,ед,жен', 'пр,ед,жен', 'им,ед,полн,муж', 'пр,ед', 'дат,ед'}]]
влажных районах	[['влажный', {'вин,мн', 'род,мн', 'пр,мн'}], ['район', {'пр,мн'}]]
влажных ладоней	[['влажный', {'вин,мн', 'род,мн', 'пр,мн'}], ['ладонь', {'род,мн'}]]
влажная одежда	[['влажный', {'им,ед'}], ['одежда', {'им,ед'}]]
влажным участкам	[['влажный', {'твор,ед', 'дат,мн'}], ['участок', {'дат,мн'}]]
влажной эпохе	[['влажный', {'твор,ед', 'пр,ед', 'дат,ед', 'род,ед'}], ['эпоха', {'пр,ед', 'дат,ед'}]]
влажных рельсах	[['влажный', {'вин,мн', 'род,мн', 'пр,мн'}], ['рельс', {'пр,мн'}]]
влажные месяцы	[['влажный', {'им,мн', 'вин,мн'}], ['месяц', {'им,мн', 'вин,мн'}]]
влажная уборка	[['влажный', {'им,ед'}], ['уборка', {'им,ед'}]]
влажным теплом	[['влажный', {'твор,ед', 'дат,мн'}], ['теплый=A=пр,ед,полн,муж', {'твор,ед', 'пр,ед,полн,сред', 'пр,ед,полн,муж'}]]
влажной коре	[['влажный', {'твор,ед', 'пр,ед', 'дат,ед', 'род,ед'}], ['кора', {'пр,ед', 'дат,ед'}]]
влажный ком	[['влажный', {'вин,ед', 'им,ед'}], ['кто=SPRO,ед,муж,од=пр', {'вин,ед', 'пр,ед', 'им,ед', 'род,мн'}]]
влажном лице	[['влажный', {'пр,ед'}], ['лицо', {'пр,ед'}]]
влажных растений	[['влажный', {'вин,мн', 'род,мн', 'пр,мн'}], ['растение', {'род,мн'}]]
влажным стациям	[['влажный', {'твор,ед', 'дат,мн'}], ['стация', {'дат,мн'}]]
влажных земель	[['влажный', {'вин,мн', 'род,мн', 'пр,мн'}], ['земля', {'род,мн'}]]
влажной штукатурке	[['влажный', {'твор,ед', 'пр,ед', 'дат,ед', 'род,ед'}], ['штукатурка', {'пр,ед', 'дат,ед'}]]
влажных материалах	[['влажный', {'вин,мн', 'род,мн', 'пр,мн'}], ['материал', {'пр,мн'}]]
влажной мешковиной	[['влажный', {'твор,ед', 'пр,ед', 'дат,ед', 'род,ед'}], ['мешковина', {'твор,ед'}]]
влажной гальке	[['влажный', {'твор,ед', 'пр,ед', 'дат,ед', 'род,ед'}], ['галька', {'пр,ед', 'дат,ед'}]]
влажными руками	[['влажный', {'твор,мн'}], ['рука', {'твор,мн'}]]
влажном лбу	[['влажный', {'пр,ед'}], ['лоб', {'местн,ед', 'дат,ед'}]]
влажных дней	[['влажный', {'вин,мн', 'род,мн', 'пр,мн'}], ['день', {'род,мн'}]]
влажными лепестками	[['влажный', {'твор,мн'}], ['лепесток', {'твор,мн'}]]
влажном песке	[['влажный', {'пр,ед'}], ['песок', {'пр,ед'}]]
влажный вздох	[['влажный', {'вин,ед', 'им,ед'}], ['вздох', {'вин,ед', 'им,ед'}]]
влажное тепло	[['влажный', {'вин,ед', 'им,ед'}], ['тепло', {'', 'вин,ед', 'им,ед', 'ед,кр,сред'}]]
влажной биомассы	[['влажный', {'твор,ед', 'пр,ед', 'дат,ед', 'род,ед'}], ['биомасса', {'им,мн', 'вин,мн', 'род,ед'}]]
влажного зерна	[['влажный', {'вин,ед', 'род,ед'}], ['зерно', {'им,мн', 'вин,мн', 'род,ед'}]]
влажной тяжестью	[['влажный', {'твор,ед', 'пр,ед', 'дат,ед', 'род,ед'}], ['тяжесть', {'твор,ед'}]]
влажным духом	[['влажный', {'твор,ед', 'дат,мн'}], ['дух', {'', 'твор,ед'}]]
влажной гангрены	[['влажный', {'твор,ед', 'пр,ед', 'дат,ед', 'род,ед'}], ['гангрена', {'им,мн', 'вин,мн', 'род,ед'}]]
влажной подстилки	[['влажный', {'твор,ед', 'пр,ед', 'дат,ед', 'род,ед'}], ['подстилка', {'им,мн', 'вин,мн', 'род,ед'}]]
влажными типами	[['влажный', {'твор,мн'}], ['тип', {'твор,мн'}]]
влажные корма	[['влажный', {'им,мн', 'вин,мн'}], ['корм', {'им,мн', 'вин,мн', 'род,ед', 'им,ед'}]]
влажные тучи	[['влажный', {'им,мн', 'вин,мн'}], ['туча', {'им,мн', 'вин,мн', 'род,ед'}]]
влажному ветру	[['влажный', {'дат,ед'}], ['ветер', {'местн,ед', 'дат,ед'}]]
влажных частях	[['влажный', {'вин,мн', 'род,мн', 'пр,мн'}], ['часть', {'пр,мн'}]]
влажной стене	[['влажный', {'твор,ед', 'пр,ед', 'дат,ед', 'род,ед'}], ['стена', {'пр,ед', 'дат,ед'}]]
влажные края	[['влажный', {'им,мн', 'вин,мн'}], ['край', {'им,мн', 'вин,мн', 'род,ед'}]]
влажному пару	[['влажный', {'дат,ед'}], ['пара', {'местн,ед', 'вин,ед', 'дат,ед', 'парт,ед'}]]
влажный дух	[['влажный', {'вин,ед', 'им,ед'}], ['дух', {'вин,ед', 'им,ед'}]]
влажное протравливание	[['влажный', {'вин,ед', 'им,ед'}], ['протравливание', {'вин,ед', 'им,ед'}]]
влажным способом	[['влажный', {'твор,ед', 'дат,мн'}], ['способ', {'твор,ед'}]]
влажной гангрене	[['влажный', {'твор,ед', 'пр,ед', 'дат,ед', 'род,ед'}], ['гангрена', {'пр,ед', 'дат,ед'}]]
влажным тампоном	[['влажный', {'твор,ед', 'дат,мн'}], ['тампон', {'твор,ед'}]]
влажные участки	[['влажный', {'им,мн', 'вин,мн'}], ['участок', {'им,мн', 'вин,мн'}]]
влажная эпоха	[['влажный', {'им,ед'}], ['эпоха', {'им,ед'}]]
влажных смесей	[['влажный', {'вин,мн', 'род,мн', 'пр,мн'}], ['смесь', {'род,мн'}]]
влажное лето	[['влажный', {'вин,ед', 'им,ед'}], ['лето', {'вин,ед', 'им,ед'}]]
влажный пласт	[['влажный', {'вин,ед', 'им,ед'}], ['пласт', {'вин,ед', 'им,ед'}]]
влажных склонов	[['влажный', {'вин,мн', 'род,мн', 'пр,мн'}], ['склон', {'род,мн'}]]
влажными тропиками	[['влажный', {'твор,мн'}], ['тропики', {'твор,мн'}]]
влажное чело	[['влажный', {'вин,ед', 'им,ед'}], ['чело', {'вин,ед', 'им,ед'}]]
влажными очами	[['влажный', {'твор,мн'}], ['око', {'твор,мн'}]]
влажных семенах	[['влажный', {'вин,мн', 'род,мн', 'пр,мн'}], ['семя', {'пр,мн'}]]
влажная ладонь	[['влажный', {'им,ед'}], ['ладонь', {'вин,ед', 'им,ед'}]]
влажную осень	[['влажный', {'вин,ед'}], ['осень', {'вин,ед', 'им,ед'}]]
влажного пара	[['влажный', {'вин,ед', 'род,ед'}], ['пара', {'им,ед', 'род,ед'}]]
влажное дуновение	[['влажный', {'вин,ед', 'им,ед'}], ['дуновение', {'вин,ед', 'им,ед'}]]
влажного воз	[['влажный', {'вин,ед', 'род,ед'}], ['воз', {'вин,ед', 'им,ед'}]]
влажных паров	[['влажный', {'вин,мн', 'род,мн', 'пр,мн'}], ['пар', {'род,мн'}]]
влажная листва	[['влажный', {'им,ед'}], ['листва', {'им,ед'}]]
влажной спине	[['влажный', {'твор,ед', 'пр,ед', 'дат,ед', 'род,ед'}], ['спина', {'пр,ед', 'дат,ед'}]]
влажных ельников	[['влажный', {'вин,мн', 'род,мн', 'пр,мн'}], ['ельник', {'род,мн', 'им,ед'}]]
влажную теплоту	[['влажный', {'вин,ед'}], ['теплота', {'вин,ед'}]]
влажных выпадений	[['влажный', {'вин,мн', 'род,мн', 'пр,мн'}], ['выпадение', {'род,мн'}]]
влажной траве	[['влажный', {'твор,ед', 'пр,ед', 'дат,ед', 'род,ед'}], ['трава', {'пр,ед', 'дат,ед'}]]
влажных хлебов	[['влажный', {'вин,мн', 'род,мн', 'пр,мн'}], ['хлеб', {'род,мн'}]]
влажным светом	[['влажный', {'твор,ед', 'дат,мн'}], ['свет', {'твор,ед'}]]
влажных сред	[['влажный', {'вин,мн', 'род,мн', 'пр,мн'}], ['среда', {'род,мн'}]]
влажные смеси	[['влажный', {'им,мн', 'вин,мн'}], ['смесь', {'им,мн', 'вин,мн', 'род,ед', 'пр,ед', 'дат,ед', 'ед,пов,2-л'}]]
влажной духоте	[['влажный', {'твор,ед', 'пр,ед', 'дат,ед', 'род,ед'}], ['духота', {'пр,ед', 'дат,ед'}]]
влажным золотом	[['влажный', {'твор,ед', 'дат,мн'}], ['золото', {'пр,ед,полн,муж', 'пр,ед', 'пр,ед,полн,сред', 'твор,ед'}]]
влажной атмосфер	[['влажный', {'твор,ед', 'пр,ед', 'дат,ед', 'род,ед'}], ['атмосфера', {'род,мн'}]]
влажный мрак	[['влажный', {'вин,ед', 'им,ед'}], ['мрак', {'вин,ед', 'им,ед'}]]
влажных дубравах	[['влажный', {'вин,мн', 'род,мн', 'пр,мн'}], ['дубрава', {'пр,мн'}]]
влажную поверхность	[['влажный', {'вин,ед'}], ['поверхность', {'вин,ед', 'им,ед'}]]
влажному лесу	[['влажный', {'дат,ед'}], ['лес', {'местн,ед', 'вин,ед', 'дат,ед', 'парт,ед'}]]
влажные глазки	[['влажный', {'им,мн', 'вин,мн'}], ['глазок', {'им,мн', 'вин,мн'}]]
влажные дни	[['влажный', {'им,мн', 'вин,мн'}], ['день', {'им,мн', 'вин,мн'}]]
влажным мхом	[['влажный', {'твор,ед', 'дат,мн'}], ['мох', {'твор,ед'}]]
влажный газ	[['влажный', {'вин,ед', 'им,ед'}], ['газ', {'вин,ед', 'им,ед'}]]
влажный жир	[['влажный', {'вин,ед', 'им,ед'}], ['жир', {'вин,ед', 'им,ед'}]]
влажной тени	[['влажный', {'твор,ед', 'пр,ед', 'дат,ед', 'род,ед'}], ['тень', {'им,мн', 'вин,мн', 'род,ед', 'пр,ед', 'дат,ед', 'ед,пов,2-л'}]]
влажной пленкой	[['влажный', {'твор,ед', 'пр,ед', 'дат,ед', 'род,ед'}], ['пленка', {'твор,ед'}]]
влажный пол	[['влажный', {'вин,ед', 'им,ед'}], ['пол', {'вин,ед', 'им', 'вин', 'им,ед', 'ед,кр,муж', 'род,мн'}]]
влажные поверхности	[['влажный', {'им,мн', 'вин,мн'}], ['поверхность', {'им,мн', 'вин,мн', 'пр,ед', 'дат,ед', 'род,ед'}]]
влажную ладонь	[['влажный', {'вин,ед'}], ['ладонь', {'вин,ед', 'им,ед'}]]
влажные губки	[['влажный', {'им,мн', 'вин,мн'}], ['губка', {'им,мн', 'вин,мн', 'род,ед'}]]
влажных тундрах	[['влажный', {'вин,мн', 'род,мн', 'пр,мн'}], ['тундра', {'пр,мн'}]]
влажных года	[['влажный', {'вин,мн', 'род,мн', 'пр,мн'}], ['год', {'им,мн', 'вин,мн', 'род,ед'}]]
влажной ладошкой	[['влажный', {'твор,ед', 'пр,ед', 'дат,ед', 'род,ед'}], ['ладошка', {'твор,ед'}]]
влажная прохлада	[['влажный', {'им,ед'}], ['прохлада', {'им,ед'}]]
влажным субстратом	[['влажный', {'твор,ед', 'дат,мн'}], ['субстрат', {'твор,ед'}]]
влажной дымке	[['влажный', {'твор,ед', 'пр,ед', 'дат,ед', 'род,ед'}], ['дымок', {'пр,ед', 'дат,ед'}]]
влажные власы	[['влажный', {'им,мн', 'вин,мн'}], ['власы', {'им,мн', 'вин,мн'}]]
влажную стену	[['влажный', {'вин,ед'}], ['стена', {'вин,ед', 'дат,ед'}]]
влажных горах	[['влажный', {'вин,мн', 'род,мн', 'пр,мн'}], ['гора', {'пр,мн'}]]
влажной почвы	[['влажный', {'твор,ед', 'пр,ед', 'дат,ед', 'род,ед'}], ['почва', {'им,мн', 'вин,мн', 'род,ед'}]]
влажные капли	[['влажный', {'им,мн', 'вин,мн'}], ['капля', {'им,мн', 'вин,мн', 'род,ед'}]]
влажным холодом	[['влажный', {'твор,ед', 'дат,мн'}], ['холод', {'твор,ед'}]]
влажных глазах	[['влажный', {'вин,мн', 'род,мн', 'пр,мн'}], ['глаз', {'пр,мн'}]]
влажной средой	[['влажный', {'твор,ед', 'пр,ед', 'дат,ед', 'род,ед'}], ['среда', {'твор,ед'}]]
влажными поцелуями	[['влажный', {'твор,мн'}], ['поцелуй', {'твор,мн'}]]
влажному песку	[['влажный', {'дат,ед'}], ['песок', {'дат,ед', 'парт,ед'}]]
влажного окисления	[['влажный', {'вин,ед', 'род,ед'}], ['окисление', {'им,мн', 'вин,мн', 'род,ед'}]]
влажную дорожку	[['влажный', {'вин,ед'}], ['дорожка', {'вин,ед'}]]
влажные уста	[['влажный', {'им,мн', 'вин,мн'}], ['уста', {'им,мн', 'вин,мн', 'им,ед'}]]
влажные понижения	[['влажный', {'им,мн', 'вин,мн'}], ['понижение', {'им,мн', 'вин,мн', 'род,ед'}]]
влажные страны	[['влажный', {'им,мн', 'вин,мн'}], ['страна', {'им,мн', 'вин,мн', 'род,ед'}]]
влажный затылок	[['влажный', {'вин,ед', 'им,ед'}], ['затылок', {'вин,ед', 'им,ед'}]]
влажную прядь	[['влажный', {'вин,ед'}], ['прядь', {'вин,ед', 'им,ед'}]]
влажные звездочки	[['влажный', {'им,мн', 'вин,мн'}], ['звездочка', {'им,мн', 'вин,мн', 'род,ед'}]]
влажного месяца	[['влажный', {'вин,ед', 'род,ед'}], ['месяц', {'род,ед'}]]
влажные долы	[['влажный', {'им,мн', 'вин,мн'}], ['дол', {'им,мн', 'вин,мн'}]]
влажной мешанки	[['влажный', {'твор,ед', 'пр,ед', 'дат,ед', 'род,ед'}], ['мешанка', {'им,мн', 'вин,мн', 'род,ед'}]]
влажного блеска	[['влажный', {'вин,ед', 'род,ед'}], ['блеск', {'род,ед'}]]
влажной окисью	[['влажный', {'твор,ед', 'пр,ед', 'дат,ед', 'род,ед'}], ['окись', {'твор,ед'}]]
влажных низменностях	[['влажный', {'вин,мн', 'род,мн', 'пр,мн'}], ['низменность', {'пр,мн'}]]
влажных местоположениях	[['влажный', {'вин,мн', 'род,мн', 'пр,мн'}], ['местоположение', {'пр,мн'}]]
влажную зелень	[['влажный', {'вин,ед'}], ['зелень', {'вин,ед', 'им,ед'}]]
влажными месяцами	[['влажный', {'твор,мн'}], ['месяц', {'', 'твор,мн'}]]
влажный лобъ	[['влажный', {'вин,ед', 'им,ед'}], ['лоб', {'вин,ед', 'им,ед'}]]
влажными хлопьями	[['влажный', {'твор,мн'}], ['хлопья', {'твор,мн'}]]
влажную глубину	[['влажный', {'вин,ед'}], ['глубина', {'вин,ед'}]]
влажные волны	[['влажный', {'им,мн', 'вин,мн'}], ['волна', {'им,мн', 'вин,мн', 'род,ед'}]]
влажной темноте	[['влажный', {'твор,ед', 'пр,ед', 'дат,ед', 'род,ед'}], ['темнота', {'пр,ед', 'дат,ед'}]]
влажный мрамор	[['влажный', {'вин,ед', 'им,ед'}], ['мрамор', {'вин,ед', 'им,ед'}]]
влажных грунтов	[['влажный', {'вин,мн', 'род,мн', 'пр,мн'}], ['грунт', {'род,мн', 'ед,кр,муж'}]]
влажного геля	[['влажный', {'вин,ед', 'род,ед'}], ['гель', {'род,ед'}]]
влажном торфе	[['влажный', {'пр,ед'}], ['торф', {'пр,ед'}]]
влажным взглядом	[['влажный', {'твор,ед', 'дат,мн'}], ['взгляд', {'твор,ед'}]]
влажных углей	[['влажный', {'вин,мн', 'род,мн', 'пр,мн'}], ['уголь', {'род,мн'}]]
влажной смолы	[['влажный', {'твор,ед', 'пр,ед', 'дат,ед', 'род,ед'}], ['смола', {'им,мн', 'вин,мн', 'род,ед'}]]
влажных газет	[['влажный', {'вин,мн', 'род,мн', 'пр,мн'}], ['газета', {'род,мн'}]]
влажные стволы	[['влажный', {'им,мн', 'вин,мн'}], ['ствол', {'им,мн', 'вин,мн'}]]
влажного продукта	[['влажный', {'вин,ед', 'род,ед'}], ['продукт', {'род,ед'}]]
влажным микроклиматом	[['влажный', {'твор,ед', 'дат,мн'}], ['микроклимат', {'твор,ед'}]]
влажным типом	[['влажный', {'твор,ед', 'дат,мн'}], ['тип', {'твор,ед'}]]
влажные глины	[['влажный', {'им,мн', 'вин,мн'}], ['глина', {'им,мн', 'вин,мн', 'род,ед'}]]
влажные местообитания	[['влажный', {'им,мн', 'вин,мн'}], ['местообитание', {'им,мн', 'вин,мн', 'род,ед'}]]
влажной тканью	[['влажный', {'твор,ед', 'пр,ед', 'дат,ед', 'род,ед'}], ['ткань', {'дат,ед', 'твор,ед'}]]
влажного угля	[['влажный', {'вин,ед', 'род,ед'}], ['уголь', {'род,ед'}]]
влажным летом	[['влажный', {'твор,ед', 'дат,мн'}], ['лето', {'', 'твор,ед'}]]
влажный мир	[['влажный', {'вин,ед', 'им,ед'}], ['мир', {'вин,ед', 'им,ед', 'род,мн', 'вин,мн'}]]
влажный сыр	[['влажный', {'вин,ед', 'им,ед'}], ['сыр', {'вин,ед', 'им,ед', 'ед,кр,муж'}]]
влажными лугами	[['влажный', {'твор,мн'}], ['луг', {'твор,мн'}]]
влажная область	[['влажный', {'им,ед'}], ['область', {'вин,ед', 'им,ед'}]]
влажных участках	[['влажный', {'вин,мн', 'род,мн', 'пр,мн'}], ['участок', {'пр,мн'}]]
влажный ветер	[['влажный', {'вин,ед', 'им,ед'}], ['ветер', {'вин,ед', 'им,ед'}]]
влажными боками	[['влажный', {'твор,мн'}], ['бок', {'твор,мн'}]]
влажными туманами	[['влажный', {'твор,мн'}], ['туман', {'твор,мн'}]]
влажным ветерком	[['влажный', {'твор,ед', 'дат,мн'}], ['ветерок', {'твор,ед'}]]
влажной сирени	[['влажный', {'твор,ед', 'пр,ед', 'дат,ед', 'род,ед'}], ['сирень', {'им,мн', 'вин,мн', 'пр,ед', 'дат,ед', 'род,ед'}]]
влажный свет	[['влажный', {'вин,ед', 'им,ед'}], ['свет', {'вин,ед', 'им,ед', 'вин,мн', 'род,мн'}]]
влажная духота	[['влажный', {'им,ед'}], ['духота', {'им,ед'}]]
влажною лапкой	[['влажный', {'твор,ед'}], ['лапка', {'твор,ед'}]]
влажных ущельях	[['влажный', {'вин,мн', 'род,мн', 'пр,мн'}], ['ущелие', {'пр,мн'}]]
влажной ветошью	[['влажный', {'твор,ед', 'пр,ед', 'дат,ед', 'род,ед'}], ['ветошь', {'твор,ед'}]]
влажную среду	[['влажный', {'вин,ед'}], ['среда', {'вин,ед'}]]
влажный снег	[['влажный', {'вин,ед', 'им,ед'}], ['снег', {'вин,ед', 'им,ед'}]]
влажный бетон	[['влажный', {'вин,ед', 'им,ед'}], ['бетон', {'вин,ед', 'им,ед'}]]
влажную зиму	[['влажный', {'вин,ед'}], ['зима', {'вин,ед', 'дат,ед'}]]
влажные струи	[['влажный', {'им,мн', 'вин,мн'}], ['струя', {'им,мн', 'вин,мн', 'род,ед', 'ед,пов,2-л'}]]
влажный дерн	[['влажный', {'вин,ед', 'им,ед'}], ['дерн', {'вин,ед', 'им,ед'}]]
влажные поручни	[['влажный', {'им,мн', 'вин,мн'}], ['поручень', {'им,мн', 'вин,мн'}]]
влажной травой	[['влажный', {'твор,ед', 'пр,ед', 'дат,ед', 'род,ед'}], ['трава', {'твор,ед'}]]
влажного хлеба	[['влажный', {'вин,ед', 'род,ед'}], ['хлеб', {'им,мн', 'вин,мн', 'род,ед'}]]
влажными слоями	[['влажный', {'твор,мн'}], ['слой', {'твор,мн'}]]
влажным песком	[['влажный', {'твор,ед', 'дат,мн'}], ['песок', {'твор,ед'}]]
влажном теле	[['влажный', {'пр,ед'}], ['тело', {'', 'пр,ед'}]]
влажным условиям	[['влажный', {'твор,ед', 'дат,мн'}], ['условие', {'дат,мн'}]]
влажная зима	[['влажный', {'им,ед'}], ['зима', {'им,ед', 'род,ед'}]]
влажной тенью	[['влажный', {'твор,ед', 'пр,ед', 'дат,ед', 'род,ед'}], ['тень', {'твор,ед'}]]
влажный полумрак	[['влажный', {'вин,ед', 'им,ед'}], ['полумрак', {'вин,ед', 'им,ед'}]]
влажные джунгли	[['влажный', {'им,мн', 'вин,мн'}], ['джунгли', {'им,мн', 'вин,мн'}]]
влажной камеры	[['влажный', {'твор,ед', 'пр,ед', 'дат,ед', 'род,ед'}], ['камера', {'им,мн', 'вин,мн', 'род,ед'}]]
влажной мутности	[['влажный', {'твор,ед', 'пр,ед', 'дат,ед', 'род,ед'}], ['мутность', {'им,мн', 'вин,мн', 'пр,ед', 'дат,ед', 'род,ед'}]]
влажном сене	[['влажный', {'пр,ед'}], ['сено', {'пр,ед', 'дат,ед'}]]
влажные деревья	[['влажный', {'им,мн', 'вин,мн'}], ['дерево', {'им,мн', 'вин,мн'}]]
влажной осени	[['влажный', {'твор,ед', 'пр,ед', 'дат,ед', 'род,ед'}], ['осень', {'им,мн', 'вин,мн', 'род,ед', 'пр,ед', 'дат,ед', 'ед,пов,2-л,сов'}]]
влажная масса	[['влажный', {'им,ед'}], ['масса', {'им,ед'}]]
влажной одежды	[['влажный', {'твор,ед', 'пр,ед', 'дат,ед', 'род,ед'}], ['одежда', {'им,мн', 'вин,мн', 'род,ед'}]]
влажных стенах	[['влажный', {'вин,мн', 'род,мн', 'пр,мн'}], ['стена', {'пр,мн'}]]
влажными стенками	[['влажный', {'твор,мн'}], ['стенка', {'твор,мн'}]]
влажное сырье	[['влажный', {'вин,ед', 'им,ед'}], ['сырье', {'вин,ед', 'пр,ед', 'им,ед'}]]
влажного периода	[['влажный', {'вин,ед', 'род,ед'}], ['период', {'род,ед'}]]
влажных углях	[['влажный', {'вин,мн', 'род,мн', 'пр,мн'}], ['уголь', {'пр,мн'}]]
влажную природу	[['влажный', {'вин,ед'}], ['природа', {'вин,ед'}]]
влажных лесах	[['влажный', {'вин,мн', 'род,мн', 'пр,мн'}], ['лес', {'пр,мн'}]]
влажному грунту	[['влажный', {'дат,ед'}], ['грунт', {'местн,ед', 'дат,ед'}]]
влажного состояния	[['влажный', {'вин,ед', 'род,ед'}], ['состояние', {'им,мн', 'вин,мн', 'род,ед'}]]
влажной мглы	[['влажный', {'твор,ед', 'пр,ед', 'дат,ед', 'род,ед'}], ['мгла', {'им,мн', 'вин,мн', 'род,ед'}]]
влажных тел	[['влажный', {'вин,мн', 'род,мн', 'пр,мн'}], ['тело', {'род,мн'}]]
влажные шкурки	[['влажный', {'им,мн', 'вин,мн'}], ['шкурка', {'им,мн', 'вин,мн', 'род,ед'}]]
влажная губка	[['влажный', {'им,ед'}], ['губка', {'им,ед'}]]
влажной шихты	[['влажный', {'твор,ед', 'пр,ед', 'дат,ед', 'род,ед'}], ['шихта', {'им,мн', 'вин,мн', 'род,ед'}]]
влажный ствол	[['влажный', {'вин,ед', 'им,ед'}], ['ствол', {'вин,ед', 'им,ед'}]]
влажные тундры	[['влажный', {'им,мн', 'вин,мн'}], ['тундра', {'им,мн', 'вин,мн', 'род,ед'}]]
влажной плоти	[['влажный', {'твор,ед', 'пр,ед', 'дат,ед', 'род,ед'}], ['плоть', {'им,мн', 'вин,мн', 'род,ед', 'пр,ед', 'дат,ед', 'ед,пов,2-л'}]]
влажных меж	[['влажный', {'вин,мн', 'род,мн', 'пр,мн'}], ['меж=PR=', {'', 'род,мн'}]]
влажного кислорода	[['влажный', {'вин,ед', 'род,ед'}], ['кислород', {'род,ед'}]]
влажной ночью	[['влажный', {'твор,ед', 'пр,ед', 'дат,ед', 'род,ед'}], ['ночь', {'', 'твор,ед'}]]
влажными мхами	[['влажный', {'твор,мн'}], ['мох', {'твор,мн'}]]
влажного вещества	[['влажный', {'вин,ед', 'род,ед'}], ['вещество', {'им,мн', 'вин,мн', 'род,ед'}]]
влажную соль	[['влажный', {'вин,ед'}], ['соль', {'вин,ед', 'дат,мн', 'им,мн', 'вин,мн', 'им,ед', 'твор,мн', 'пр,мн', 'твор,ед', 'род,мн', 'род,ед', 'пр,ед', 'дат,ед'}]]
влажным районом	[['влажный', {'твор,ед', 'дат,мн'}], ['район', {'твор,ед'}]]
влажный куст	[['влажный', {'вин,ед', 'им,ед'}], ['куст', {'вин,ед', 'им,ед'}]]
влажных стран	[['влажный', {'вин,мн', 'род,мн', 'пр,мн'}], ['страна', {'род,мн'}]]
влажным водородом	[['влажный', {'твор,ед', 'дат,мн'}], ['водород', {'твор,ед'}]]
влажные скалы	[['влажный', {'им,мн', 'вин,мн'}], ['скала', {'им,мн', 'вин,мн', 'род,ед'}]]
влажный запахъ	[['влажный', {'вин,ед', 'им,ед'}], ['запах', {'прош,ед,изъяв,муж', 'вин,ед', 'им,ед'}]]
влажные туманы	[['влажный', {'им,мн', 'вин,мн'}], ['туман', {'им,мн', 'вин,мн'}]]
влажным хрустом	[['влажный', {'твор,ед', 'дат,мн'}], ['хруст', {'твор,ед'}]]
влажной тишины	[['влажный', {'твор,ед', 'пр,ед', 'дат,ед', 'род,ед'}], ['тишина', {'им,мн', 'род,ед'}]]
влажной материей	[['влажный', {'твор,ед', 'пр,ед', 'дат,ед', 'род,ед'}], ['материя', {'твор,ед'}]]
влажного обеззараживания	[['влажный', {'вин,ед', 'род,ед'}], ['обеззараживание', {'им,мн', 'вин,мн', 'род,ед'}]]
влажный вес	[['влажный', {'вин,ед', 'им,ед'}], ['вес', {'вин,ед', 'им,ед'}]]
влажную пленку	[['влажный', {'вин,ед'}], ['пленка', {'вин,ед'}]]
влажной весны	[['влажный', {'твор,ед', 'пр,ед', 'дат,ед', 'род,ед'}], ['весна', {'им,мн', 'вин,мн', 'род,ед'}]]
влажный шум	[['влажный', {'вин,ед', 'им,ед'}], ['шум', {'вин,ед', 'им,ед'}]]
влажного твердения	[['влажный', {'вин,ед', 'род,ед'}], ['твердение', {'им,мн', 'вин,мн', 'род,ед'}]]
влажных трав	[['влажный', {'вин,мн', 'род,мн', 'пр,мн'}], ['трава', {'род,мн'}]]
влажной стены	[['влажный', {'твор,ед', 'пр,ед', 'дат,ед', 'род,ед'}], ['стена', {'им,мн', 'вин,мн', 'род,ед'}]]
влажных запахов	[['влажный', {'вин,мн', 'род,мн', 'пр,мн'}], ['запах', {'род,мн'}]]
влажных пней	[['влажный', {'вин,мн', 'род,мн', 'пр,мн'}], ['пень', {'род,мн'}]]
влажных субтропиках	[['влажный', {'вин,мн', 'род,мн', 'пр,мн'}], ['субтропики', {'пр,мн'}]]
влажного сорбента	[['влажный', {'вин,ед', 'род,ед'}], ['сорбент', {'род,ед'}]]
влажных камер	[['влажный', {'вин,мн', 'род,мн', 'пр,мн'}], ['камера', {'род,мн'}]]
влажными смесями	[['влажный', {'твор,мн'}], ['смесь', {'твор,мн'}]]
влажном иле	[['влажный', {'пр,ед'}], ['ил', {'пр,ед'}]]
влажная смесь	[['влажный', {'им,ед'}], ['смесь', {'вин,ед', 'им,ед'}]]
влажные рытвины	[['влажный', {'им,мн', 'вин,мн'}], ['рытвина', {'им,мн', 'вин,мн', 'род,ед'}]]
влажного концентрата	[['влажный', {'вин,ед', 'род,ед'}], ['концентрат', {'род,ед'}]]
влажных проб	[['влажный', {'вин,мн', 'род,мн', 'пр,мн'}], ['проба', {'род,мн'}]]
влажных ложбинах	[['влажный', {'вин,мн', 'род,мн', 'пр,мн'}], ['ложбина', {'пр,мн'}]]
влажном горении	[['влажный', {'пр,ед'}], ['горение', {'пр,ед'}]]
влажной извести	[['влажный', {'твор,ед', 'пр,ед', 'дат,ед', 'род,ед'}], ['известь', {'им,мн', 'вин,мн', 'род,ед', 'инф,сов', 'пр,ед', 'дат,ед', 'ед,пов,2-л,сов'}]]
влажные облака	[['влажный', {'им,мн', 'вин,мн'}], ['облако', {'им,мн', 'вин,мн', 'род,ед'}]]
влажной тряпки	[['влажный', {'твор,ед', 'пр,ед', 'дат,ед', 'род,ед'}], ['тряпка', {'им,мн', 'вин,мн', 'род,ед'}]]
влажные склоны	[['влажный', {'им,мн', 'вин,мн'}], ['склон', {'им,мн', 'вин,мн'}]]
влажной заре	[['влажный', {'твор,ед', 'пр,ед', 'дат,ед', 'род,ед'}], ['заря', {'пр,ед', 'дат,ед'}]]
влажных тканей	[['влажный', {'вин,мн', 'род,мн', 'пр,мн'}], ['ткань', {'срав', 'род,мн'}]]
влажной полосе	[['влажный', {'твор,ед', 'пр,ед', 'дат,ед', 'род,ед'}], ['полоса', {'пр,ед', 'дат,ед'}]]
влажного климатов	[['влажный', {'вин,ед', 'род,ед'}], ['климат', {'род,мн'}]]
влажный сдвиг	[['влажный', {'вин,ед', 'им,ед'}], ['сдвиг', {'вин,ед', 'им,ед'}]]
влажным кислородом	[['влажный', {'твор,ед', 'дат,мн'}], ['кислород', {'твор,ед'}]]
влажных борах	[['влажный', {'вин,мн', 'род,мн', 'пр,мн'}], ['бор', {'пр,мн'}]]
влажной ваткой	[['влажный', {'твор,ед', 'пр,ед', 'дат,ед', 'род,ед'}], ['ватка', {'твор,ед'}]]
влажнее воздух	[['влажный', {'срав'}], ['воздух', {'вин,ед', 'им,ед'}]]
влажной тряпочке	[['влажный', {'твор,ед', 'пр,ед', 'дат,ед', 'род,ед'}], ['тряпочка', {'пр,ед', 'дат,ед'}]]
влажных песков	[['влажный', {'вин,мн', 'род,мн', 'пр,мн'}], ['песок', {'род,мн', 'им,ед'}]]
влажные тела	[['влажный', {'им,мн', 'вин,мн'}], ['тело', {'им,мн', 'вин,мн', 'род,ед'}]]
влажных стеблей	[['влажный', {'вин,мн', 'род,мн', 'пр,мн'}], ['стебель', {'род,мн'}]]
влажным туманом	[['влажный', {'твор,ед', 'дат,мн'}], ['туман', {'твор,ед'}]]
влажная звезда	[['влажный', {'им,ед'}], ['звезда', {'им,ед'}]]
влажной стихии	[['влажный', {'твор,ед', 'пр,ед', 'дат,ед', 'род,ед'}], ['стихия', {'им,мн', 'вин,мн', 'пр,ед', 'дат,ед', 'род,ед'}]]
влажную одежду	[['влажный', {'вин,ед'}], ['одежда', {'вин,ед'}]]
влажном лугу	[['влажный', {'пр,ед'}], ['луг', {'местн,ед', 'вин,ед', 'дат,ед'}]]
влажное крыльцо	[['влажный', {'вин,ед', 'им,ед'}], ['крыльцо', {'вин,ед', 'им,ед'}]]
влажных крыш	[['влажный', {'вин,мн', 'род,мн', 'пр,мн'}], ['крыша', {'род,мн'}]]
влажные листья	[['влажный', {'им,мн', 'вин,мн'}], ['лист', {'им,мн', 'вин,мн'}]]
влажного хлопка	[['влажный', {'вин,ед', 'род,ед'}], ['хлопок', {'род,ед'}]]
влажная пелена	[['влажный', {'им,ед'}], ['пелена', {'им,ед'}]]
влажный шарик	[['влажный', {'вин,ед', 'им,ед'}], ['шарик', {'вин,ед', 'им,ед'}]]
влажной шерстью	[['влажный', {'твор,ед', 'пр,ед', 'дат,ед', 'род,ед'}], ['шерсть', {'твор,ед'}]]
влажных початков	[['влажный', {'вин,мн', 'род,мн', 'пр,мн'}], ['початок', {'род,мн'}]]
влажных полях	[['влажный', {'вин,мн', 'род,мн', 'пр,мн'}], ['поле', {'пр,мн'}]]
влажного горизонта	[['влажный', {'вин,ед', 'род,ед'}], ['горизонт', {'род,ед'}]]
влажных лепестков	[['влажный', {'вин,мн', 'род,мн', 'пр,мн'}], ['лепесток', {'род,мн', 'ед,кр,муж'}]]
влажные соли	[['влажный', {'им,мн', 'вин,мн'}], ['соль', {'им,мн', 'вин,мн', 'род,ед', 'пр,ед', 'дат,ед', 'ед,пов,2-л'}]]
влажного шлама	[['влажный', {'вин,ед', 'род,ед'}], ['шлам', {'род,ед'}]]
влажных хрипов	[['влажный', {'вин,мн', 'род,мн', 'пр,мн'}], ['хрип', {'род,мн'}]]
влажными районами	[['влажный', {'твор,мн'}], ['район', {'твор,мн'}]]
влажную скамью	[['влажный', {'вин,ед'}], ['скамья', {'вин,ед'}]]
влажными волнами	[['влажный', {'твор,мн'}], ['волна', {'твор,мн'}]]
влажную дорогу	[['влажный', {'вин,ед'}], ['дорога', {'вин,ед'}]]
влажную трубку	[['влажный', {'вин,ед'}], ['трубка', {'вин,ед'}]]
влажных лугов	[['влажный', {'вин,мн', 'род,мн', 'пр,мн'}], ['луг', {'род,мн'}]]
влажной неба	[['влажный', {'твор,ед', 'пр,ед', 'дат,ед', 'род,ед'}], ['небо', {'им,мн', 'вин,мн', 'род,ед'}]]
влажном бензоле	[['влажный', {'пр,ед'}], ['бензол', {'пр,ед'}]]
влажного аргона	[['влажный', {'вин,ед', 'род,ед'}], ['аргон', {'род,ед'}]]
влажным брезентом	[['влажный', {'твор,ед', 'дат,мн'}], ['брезент', {'твор,ед'}]]
влажные сети	[['влажный', {'им,мн', 'вин,мн'}], ['сеть', {'им,мн', 'вин,мн', 'пр,ед', 'дат,ед', 'род,ед'}]]
влажной ладони	[['влажный', {'твор,ед', 'пр,ед', 'дат,ед', 'род,ед'}], ['ладонь', {'им,мн', 'вин,мн', 'пр,ед', 'дат,ед', 'род,ед'}]]
влажного сезонов	[['влажный', {'вин,ед', 'род,ед'}], ['сезон', {'род,мн'}]]
влажной смеси	[['влажный', {'твор,ед', 'пр,ед', 'дат,ед', 'род,ед'}], ['смесь', {'им,мн', 'вин,мн', 'род,ед', 'пр,ед', 'дат,ед', 'ед,пов,2-л'}]]
влажные биотопы	[['влажный', {'им,мн', 'вин,мн'}], ['биотоп', {'им,мн', 'вин,мн'}]]
влажные потоки	[['влажный', {'им,мн', 'вин,мн'}], ['поток', {'им,мн', 'вин,мн'}]]
влажном мху	[['влажный', {'пр,ед'}], ['мох', {'местн,ед', 'дат,ед', 'парт,ед'}]]
влажная кожа	[['влажный', {'им,ед'}], ['кожа', {'им,ед'}]]
влажными материалами	[['влажный', {'твор,мн'}], ['материал', {'твор,мн'}]]
влажной поверхности	[['влажный', {'твор,ед', 'пр,ед', 'дат,ед', 'род,ед'}], ['поверхность', {'им,мн', 'вин,мн', 'пр,ед', 'дат,ед', 'род,ед'}]]
влажная поверхность	[['влажный', {'им,ед'}], ['поверхность', {'вин,ед', 'им,ед'}]]
влажной части	[['влажный', {'твор,ед', 'пр,ед', 'дат,ед', 'род,ед'}], ['часть', {'им,мн', 'вин,мн', 'род,ед', 'пр,ед', 'дат,ед', 'ед,пов,2-л'}]]
влажного хранения	[['влажный', {'вин,ед', 'род,ед'}], ['хранение', {'им,мн', 'вин,мн', 'род,ед'}]]
влажном визге	[['влажный', {'пр,ед'}], ['визг', {'пр,ед'}]]
влажных местностей	[['влажный', {'вин,мн', 'род,мн', 'пр,мн'}], ['местность', {'род,мн'}]]
влажных рифм	[['влажный', {'вин,мн', 'род,мн', 'пр,мн'}], ['рифма', {'род,мн'}]]
влажный мох	[['влажный', {'вин,ед', 'им,ед'}], ['мох', {'вин,ед', 'им,ед'}]]
влажные спины	[['влажный', {'им,мн', 'вин,мн'}], ['спина', {'им,мн', 'вин,мн', 'род,ед'}]]
влажная прядь	[['влажный', {'им,ед'}], ['прядь', {'вин,ед', 'им,ед'}]]
влажных недр	[['влажный', {'вин,мн', 'род,мн', 'пр,мн'}], ['недра', {'род,мн'}]]
влажное сено	[['влажный', {'вин,ед', 'им,ед'}], ['сено', {'вин,ед', 'им,ед'}]]
влажной сыростью	[['влажный', {'твор,ед', 'пр,ед', 'дат,ед', 'род,ед'}], ['сырость', {'твор,ед'}]]
влажные районы	[['влажный', {'им,мн', 'вин,мн'}], ['район', {'им,мн', 'вин,мн'}]]
влажным воздухом	[['влажный', {'твор,ед', 'дат,мн'}], ['воздух', {'твор,ед'}]]
влажная камера	[['влажный', {'им,ед'}], ['камера', {'им,ед'}]]
влажной тьмой	[['влажный', {'твор,ед', 'пр,ед', 'дат,ед', 'род,ед'}], ['тьма', {'твор,ед'}]]
влажный запах	[['влажный', {'вин,ед', 'им,ед'}], ['запах', {'прош,ед,изъяв,муж', 'вин,ед', 'им,ед'}]]
влажному лицу	[['влажный', {'дат,ед'}], ['лицо', {'дат,ед'}]]
влажный конец	[['влажный', {'вин,ед', 'им,ед'}], ['конец', {'вин,ед', 'им,ед'}]]
влажном водороде	[['влажный', {'пр,ед'}], ['водород', {'пр,ед'}]]
влажной погоде	[['влажный', {'твор,ед', 'пр,ед', 'дат,ед', 'род,ед'}], ['погода', {'пр,ед', 'дат,ед'}]]
влажной глубины	[['влажный', {'твор,ед', 'пр,ед', 'дат,ед', 'род,ед'}], ['глубина', {'им,мн', 'вин,мн', 'род,ед'}]]
влажных туч	[['влажный', {'вин,мн', 'род,мн', 'пр,мн'}], ['туча', {'род,мн'}]]
влажным эфиром	[['влажный', {'твор,ед', 'дат,мн'}], ['эфир', {'твор,ед'}]]
влажной зонах	[['влажный', {'твор,ед', 'пр,ед', 'дат,ед', 'род,ед'}], ['зона', {'пр,мн'}]]
влажном ветре	[['влажный', {'пр,ед'}], ['ветер', {'пр,ед'}]]
влажной бумаге	[['влажный', {'твор,ед', 'пр,ед', 'дат,ед', 'род,ед'}], ['бумага', {'пр,ед', 'дат,ед'}]]
влажным ароматом	[['влажный', {'твор,ед', 'дат,мн'}], ['аромат', {'твор,ед'}]]
влажные клочья	[['влажный', {'им,мн', 'вин,мн'}], ['клок', {'им,мн', 'вин,мн'}]]
влажных средах	[['влажный', {'вин,мн', 'род,мн', 'пр,мн'}], ['среда', {'пр,мн'}]]
влажная теплынь	[['влажный', {'им,ед'}], ['теплынь', {'вин,ед', 'им,ед'}]]
влажные субтропики	[['влажный', {'им,мн', 'вин,мн'}], ['субтропики', {'им,мн', 'вин,мн'}]]
влажной породы	[['влажный', {'твор,ед', 'пр,ед', 'дат,ед', 'род,ед'}], ['порода', {'им,мн', 'вин,мн', 'род,ед'}]]
влажный аромат	[['влажный', {'вин,ед', 'им,ед'}], ['аромат', {'вин,ед', 'им,ед'}]]
влажным шорохом	[['влажный', {'твор,ед', 'дат,мн'}], ['шорох', {'твор,ед'}]]
влажных продуктов	[['влажный', {'вин,мн', 'род,мн', 'пр,мн'}], ['продукт', {'род,мн', 'ед,кр,муж'}]]
влажные корни	[['влажный', {'им,мн', 'вин,мн'}], ['корень', {'им,мн', 'вин,мн'}]]
влажными тампонами	[['влажный', {'твор,мн'}], ['тампон', {'твор,мн'}]]
влажных простынях	[['влажный', {'вин,мн', 'род,мн', 'пр,мн'}], ['простыня', {'пр,мн'}]]
влажного лета	[['влажный', {'вин,ед', 'род,ед'}], ['лето', {'им,мн', 'вин,мн', 'род,ед'}]]
влажных субтропиков	[['влажный', {'вин,мн', 'род,мн', 'пр,мн'}], ['субтропики', {'род,мн'}]]
влажном виде	[['влажный', {'пр,ед'}], ['вид', {'пр,ед'}]]
влажной испариной	[['влажный', {'твор,ед', 'пр,ед', 'дат,ед', 'род,ед'}], ['испарина', {'твор,ед'}]]
влажные саванны	[['влажный', {'им,мн', 'вин,мн'}], ['саванна', {'им,мн', 'вин,мн', 'род,ед'}]]
влажном полу	[['влажный', {'пр,ед'}], ['пол', {'', 'пр', 'род', 'вин,ед', 'твор', 'дат', 'местн,ед', 'дат,ед'}]]
влажным областям	[['влажный', {'твор,ед', 'дат,мн'}], ['область', {'дат,мн'}]]
влажная струя	[['влажный', {'им,ед'}], ['струя', {'непрош,деепр', 'им,ед'}]]
влажном месте	[['влажный', {'пр,ед'}], ['место', {'пр,ед'}]]
влажной эпохой	[['влажный', {'твор,ед', 'пр,ед', 'дат,ед', 'род,ед'}], ['эпоха', {'твор,ед'}]]
влажной обработке	[['влажный', {'твор,ед', 'пр,ед', 'дат,ед', 'род,ед'}], ['обработка', {'пр,ед', 'дат,ед'}]]
влажных почвах	[['влажный', {'вин,мн', 'род,мн', 'пр,мн'}], ['почва', {'пр,мн'}]]
влажных слоях	[['влажный', {'вин,мн', 'род,мн', 'пр,мн'}], ['слой', {'пр,мн'}]]
влажных устах	[['влажный', {'вин,мн', 'род,мн', 'пр,мн'}], ['уста', {'пр,мн'}]]
влажными условиями	[['влажный', {'твор,мн'}], ['условие', {'твор,мн'}]]
влажная тьма	[['влажный', {'им,ед'}], ['тьма', {'им,ед'}]]
влажных котловинах	[['влажный', {'вин,мн', 'род,мн', 'пр,мн'}], ['котловина', {'пр,мн'}]]
влажные брови	[['влажный', {'им,мн', 'вин,мн'}], ['бровь', {'им,мн', 'вин,мн', 'пр,ед', 'дат,ед', 'род,ед'}]]
влажный взоръ	[['влажный', {'вин,ед', 'им,ед'}], ['взор', {'вин,ед', 'им,ед'}]]
влажное слово	[['влажный', {'вин,ед', 'им,ед'}], ['слово', {'вин,ед', 'им,ед'}]]
влажные белки	[['влажный', {'им,мн', 'вин,мн'}], ['белок', {'им,мн', 'вин,мн', 'род,ед'}]]
влажная паутина	[['влажный', {'им,ед'}], ['паутина', {'им,ед'}]]
влажное небо	[['влажный', {'вин,ед', 'им,ед'}], ['небо', {'вин,ед', 'им,ед'}]]
влажными поверхностями	[['влажный', {'твор,мн'}], ['поверхность', {'твор,мн'}]]
влажном запахе	[['влажный', {'пр,ед'}], ['запах', {'пр,ед'}]]
влажные почвы	[['влажный', {'им,мн', 'вин,мн'}], ['почва', {'им,мн', 'вин,мн', 'род,ед'}]]
влажной мгле	[['влажный', {'твор,ед', 'пр,ед', 'дат,ед', 'род,ед'}], ['мгла', {'пр,ед', 'дат,ед'}]]
влажными комьями	[['влажный', {'твор,мн'}], ['ком', {'твор,мн'}]]
влажных землях	[['влажный', {'вин,мн', 'род,мн', 'пр,мн'}], ['земля', {'пр,мн'}]]
влажные волокна	[['влажный', {'им,мн', 'вин,мн'}], ['волокно', {'им,мн', 'вин,мн', 'род,ед'}]]
влажного порошка	[['влажный', {'вин,ед', 'род,ед'}], ['порошок', {'род,ед'}]]
влажные пальцы	[['влажный', {'им,мн', 'вин,мн'}], ['палец', {'им,мн', 'вин,мн'}]]
влажным долинам	[['влажный', {'твор,ед', 'дат,мн'}], ['долина', {'дат,мн'}]]
влажную тряпицу	[['влажный', {'вин,ед'}], ['тряпица', {'вин,ед'}]]
влажную дезинфекцию	[['влажный', {'вин,ед'}], ['дезинфекция', {'вин,ед'}]]
влажных зим	[['влажный', {'вин,мн', 'род,мн', 'пр,мн'}], ['зима', {'род,мн', 'вин,ед', 'им,ед'}]]
влажный климатъ	[['влажный', {'вин,ед', 'им,ед'}], ['климат', {'вин,ед', 'им,ед'}]]
влажные волосы	[['влажный', {'им,мн', 'вин,мн'}], ['волос', {'им,мн', 'вин,мн'}]]
влажный блеск	[['влажный', {'вин,ед', 'им,ед'}], ['блеск', {'вин,ед', 'им,ед'}]]
влажным ветром	[['влажный', {'твор,ед', 'дат,мн'}], ['ветер', {'твор,ед'}]]
влажного мха	[['влажный', {'вин,ед', 'род,ед'}], ['мох', {'род,ед'}]]
влажные суглинки	[['влажный', {'им,мн', 'вин,мн'}], ['суглинок', {'им,мн', 'вин,мн'}]]
влажным языком	[['влажный', {'твор,ед', 'дат,мн'}], ['язык', {'твор,ед'}]]
влажного периодов	[['влажный', {'вин,ед', 'род,ед'}], ['период', {'род,мн'}]]
влажная бумага	[['влажный', {'им,ед'}], ['бумага', {'им,ед'}]]
влажного пятна	[['влажный', {'вин,ед', 'род,ед'}], ['пятно', {'им,мн', 'вин,мн', 'род,ед'}]]
влажные породы	[['влажный', {'им,мн', 'вин,мн'}], ['порода', {'им,мн', 'вин,мн', 'род,ед'}]]
влажную полоску	[['влажный', {'вин,ед'}], ['полоска', {'вин,ед'}]]
влажного белья	[['влажный', {'вин,ед', 'род,ед'}], ['белье', {'род,ед'}]]
влажной Спас	[['влажный', {'твор,ед', 'пр,ед', 'дат,ед', 'род,ед'}], ['спас', {'вин,ед', 'им,ед', 'прош,ед,изъяв,муж,сов'}]]
влажные компрессы	[['влажный', {'им,мн', 'вин,мн'}], ['компресс', {'им,мн', 'вин,мн'}]]
влажным понижениям	[['влажный', {'твор,ед', 'дат,мн'}], ['понижение', {'дат,мн'}]]
влажную шинель	[['влажный', {'вин,ед'}], ['шинель', {'вин,ед', 'им,ед'}]]
влажным берегам	[['влажный', {'твор,ед', 'дат,мн'}], ['берег', {'дат,мн'}]]
влажный компресс	[['влажный', {'вин,ед', 'им,ед'}], ['компресс', {'вин,ед', 'им,ед'}]]
влажный гул	[['влажный', {'вин,ед', 'им,ед'}], ['гул', {'вин,ед', 'им,ед'}]]
влажной ночи	[['влажный', {'твор,ед', 'пр,ед', 'дат,ед', 'род,ед'}], ['ночь', {'им,мн', 'вин,мн', 'род,ед', 'местн,ед', 'пр,ед', 'дат,ед'}]]
влажная сирень	[['влажный', {'им,ед'}], ['сирень', {'вин,ед', 'им,ед'}]]
влажной рубашке	[['влажный', {'твор,ед', 'пр,ед', 'дат,ед', 'род,ед'}], ['рубашка', {'пр,ед', 'дат,ед'}]]
влажных деревьев	[['влажный', {'вин,мн', 'род,мн', 'пр,мн'}], ['дерево', {'род,мн'}]]
влажной духоты	[['влажный', {'твор,ед', 'пр,ед', 'дат,ед', 'род,ед'}], ['духота', {'род,ед'}]]
влажной пасти	[['влажный', {'твор,ед', 'пр,ед', 'дат,ед', 'род,ед'}], ['пасть', {'им,мн', 'вин,мн', 'род,ед', 'инф', 'пр,ед', 'дат,ед'}]]
влажного осадка	[['влажный', {'вин,ед', 'род,ед'}], ['осадок', {'род,ед', 'им,ед'}]]
влажных высокогорий	[['влажный', {'вин,мн', 'род,мн', 'пр,мн'}], ['высокогорье', {'род,мн'}]]
влажным временем	[['влажный', {'твор,ед', 'дат,мн'}], ['время', {'твор,ед'}]]
влажной полосы	[['влажный', {'твор,ед', 'пр,ед', 'дат,ед', 'род,ед'}], ['полоса', {'им,мн', 'вин,мн', 'род,ед'}]]
влажное вещество	[['влажный', {'вин,ед', 'им,ед'}], ['вещество', {'вин,ед', 'им,ед'}]]
влажных полянах	[['влажный', {'вин,мн', 'род,мн', 'пр,мн'}], ['поляна', {'пр,мн'}]]
влажного камня	[['влажный', {'вин,ед', 'род,ед'}], ['камень', {'род,ед'}]]
влажного побережья	[['влажный', {'вин,ед', 'род,ед'}], ['побережье', {'им,мн', 'вин,мн', 'род,ед'}]]
влажный осадок	[['влажный', {'вин,ед', 'им,ед'}], ['осадок', {'вин,ед', 'им,ед', 'род,мн'}]]
влажной осенью	[['влажный', {'твор,ед', 'пр,ед', 'дат,ед', 'род,ед'}], ['осень', {'', 'твор,ед'}]]
влажный лоб	[['влажный', {'вин,ед', 'им,ед'}], ['лоб', {'вин,ед', 'им,ед'}]]
влажный бог	[['влажный', {'вин,ед', 'им,ед'}], ['бог', {'им,ед'}]]
влажного асфальта	[['влажный', {'вин,ед', 'род,ед'}], ['асфальт', {'род,ед'}]]
влажную жару	[['влажный', {'вин,ед'}], ['жара', {'местн,ед', 'вин,ед', 'дат,ед', 'парт,ед'}]]
влажной долине	[['влажный', {'твор,ед', 'пр,ед', 'дат,ед', 'род,ед'}], ['долина', {'пр,ед', 'дат,ед'}]]
влажной марле	[['влажный', {'твор,ед', 'пр,ед', 'дат,ед', 'род,ед'}], ['марля', {'пр,ед', 'дат,ед'}]]
влажного зноя	[['влажный', {'вин,ед', 'род,ед'}], ['зной', {'род,ед'}]]
влажным годом	[['влажный', {'твор,ед', 'дат,мн'}], ['год', {'твор,ед'}]]
влажное платье	[['влажный', {'вин,ед', 'им,ед'}], ['платье', {'вин,ед', 'пр,ед', 'им,ед'}]]
влажным кормом	[['влажный', {'твор,ед', 'дат,мн'}], ['корм', {'твор,ед'}]]
влажная кора	[['влажный', {'им,ед'}], ['кора', {'им,ед'}]]
влажный шар	[['влажный', {'вин,ед', 'им,ед'}], ['шар', {'вин,ед', 'им,ед', 'род,мн'}]]
влажных кормов	[['влажный', {'вин,мн', 'род,мн', 'пр,мн'}], ['корм', {'род,мн'}]]
влажных листьев	[['влажный', {'вин,мн', 'род,мн', 'пр,мн'}], ['лист', {'род,мн', 'им,ед'}]]
влажный берег	[['влажный', {'вин,ед', 'им,ед'}], ['берег', {'прош,ед,изъяв,муж', 'вин,ед', 'им,ед'}]]
влажных семян	[['влажный', {'вин,мн', 'род,мн', 'пр,мн'}], ['семя', {'род,мн'}]]
влажный ил	[['влажный', {'вин,ед', 'им,ед'}], ['ил', {'вин,ед', 'им,ед'}]]
влажные глаза	[['влажный', {'им,мн', 'вин,мн'}], ['глаз', {'им,мн', 'вин,мн', 'род,ед'}]]
влажный навоз	[['влажный', {'вин,ед', 'им,ед'}], ['навоз', {'вин,ед', 'им,ед'}]]
влажные лепестки	[['влажный', {'им,мн', 'вин,мн'}], ['лепесток', {'им,мн', 'вин,мн'}]]
влажные пряди	[['влажный', {'им,мн', 'вин,мн'}], ['прядь', {'им,мн', 'вин,мн', 'ед,пов,2-л,пе', 'род,ед', 'пр,ед', 'дат,ед'}]]
влажными цветами	[['влажный', {'твор,мн'}], ['цветок', {'твор,мн'}]]
влажных салфеток	[['влажный', {'вин,мн', 'род,мн', 'пр,мн'}], ['салфетка', {'род,мн'}]]
влажному лугу	[['влажный', {'дат,ед'}], ['луг', {'местн,ед', 'вин,ед', 'дат,ед'}]]
влажных мешанках	[['влажный', {'вин,мн', 'род,мн', 'пр,мн'}], ['мешанка', {'пр,мн'}]]
влажная часть	[['влажный', {'им,ед'}], ['часть', {'вин,ед', 'им,ед'}]]
влажный взор	[['влажный', {'вин,ед', 'им,ед'}], ['взор', {'вин,ед', 'им,ед'}]]
влажной соли	[['влажный', {'твор,ед', 'пр,ед', 'дат,ед', 'род,ед'}], ['соль', {'им,мн', 'вин,мн', 'род,ед', 'пр,ед', 'дат,ед', 'ед,пов,2-л'}]]
влажном материале	[['влажный', {'пр,ед'}], ['материал', {'пр,ед'}]]
влажная среда	[['влажный', {'им,ед'}], ['среда', {'им,ед'}]]
влажной коже	[['влажный', {'твор,ед', 'пр,ед', 'дат,ед', 'род,ед'}], ['кожа', {'пр,ед', 'дат,ед'}]]
влажные цветы	[['влажный', {'им,мн', 'вин,мн'}], ['цветок', {'им,мн', 'вин,мн', 'род,ед'}]]
влажных частей	[['влажный', {'вин,мн', 'род,мн', 'пр,мн'}], ['часть', {'род,мн'}]]
влажного сезона	[['влажный', {'вин,ед', 'род,ед'}], ['сезон', {'род,ед'}]]
влажные очи	[['влажный', {'им,мн', 'вин,мн'}], ['око', {'им,мн', 'вин,мн'}]]
влажных камнях	[['влажный', {'вин,мн', 'род,мн', 'пр,мн'}], ['камень', {'пр,мн'}]]
влажный слой	[['влажный', {'вин,ед', 'им,ед'}], ['слой', {'вин,ед', 'им,ед'}]]
влажных джунглей	[['влажный', {'вин,мн', 'род,мн', 'пр,мн'}], ['джунгли', {'род,мн'}]]
влажная дезинсекция	[['влажный', {'им,ед'}], ['дезинсекция', {'им,ед'}]]
влажной корой	[['влажный', {'твор,ед', 'пр,ед', 'дат,ед', 'род,ед'}], ['кора', {'твор,ед'}]]
влажными простынями	[['влажный', {'твор,мн'}], ['простыня', {'твор,мн'}]]
влажной кисточкой	[['влажный', {'твор,ед', 'пр,ед', 'дат,ед', 'род,ед'}], ['кисточка', {'твор,ед'}]]
влажное тело	[['влажный', {'вин,ед', 'им,ед'}], ['тело', {'вин,ед', 'им,ед'}]]
влажный листок	[['влажный', {'вин,ед', 'им,ед'}], ['листок', {'вин,ед', 'им,ед'}]]
влажной синевой	[['влажный', {'твор,ед', 'пр,ед', 'дат,ед', 'род,ед'}], ['синева', {'твор,ед'}]]
влажные условия	[['влажный', {'им,мн', 'вин,мн'}], ['условие', {'им,мн', 'вин,мн', 'род,ед'}]]
влажных препаратах	[['влажный', {'вин,мн', 'род,мн', 'пр,мн'}], ['препарат', {'пр,мн'}]]
влажной шинели	[['влажный', {'твор,ед', 'пр,ед', 'дат,ед', 'род,ед'}], ['шинель', {'им,мн', 'вин,мн', 'пр,ед', 'дат,ед', 'род,ед'}]]
влажный метод	[['влажный', {'вин,ед', 'им,ед'}], ['метод', {'вин,ед', 'им,ед', 'род,мн'}]]
влажным полотенцем	[['влажный', {'твор,ед', 'дат,мн'}], ['полотенце', {'твор,ед'}]]
влажное ложе	[['влажный', {'вин,ед', 'им,ед'}], ['ложе', {'вин,ед', 'пр,ед', 'им,ед', 'дат,ед'}]]
влажные полосы	[['влажный', {'им,мн', 'вин,мн'}], ['полоса', {'им,мн', 'вин,мн', 'род,ед'}]]
влажную тряпочку	[['влажный', {'вин,ед'}], ['тряпочка', {'вин,ед'}]]
влажны глаза	[['влажный', {'мн,кр'}], ['глаз', {'им,мн', 'вин,мн', 'род,ед'}]]
влажным глазом	[['влажный', {'твор,ед', 'дат,мн'}], ['глаз', {'твор,ед'}]]
влажной улыбкой	[['влажный', {'твор,ед', 'пр,ед', 'дат,ед', 'род,ед'}], ['улыбка', {'твор,ед'}]]
влажные варианты	[['влажный', {'им,мн', 'вин,мн'}], ['вариант', {'им,мн', 'вин,мн', 'род,ед'}]]
влажных кустов	[['влажный', {'вин,мн', 'род,мн', 'пр,мн'}], ['куст', {'род,мн', 'им,ед'}]]
влажного климата	[['влажный', {'вин,ед', 'род,ед'}], ['климат', {'род,ед'}]]
влажные полоски	[['влажный', {'им,мн', 'вин,мн'}], ['полоска', {'им,мн', 'вин,мн', 'род,ед'}]]
влажный нос	[['влажный', {'вин,ед', 'им,ед'}], ['нос', {'вин,ед', 'им,ед'}]]
влажные хрипы	[['влажный', {'им,мн', 'вин,мн'}], ['хрип', {'им,мн', 'вин,мн'}]]
влажный отблеск	[['влажный', {'вин,ед', 'им,ед'}], ['отблеск', {'вин,ед', 'им,ед'}]]
влажные заросли	[['влажный', {'им,мн', 'вин,мн'}], ['заросль', {'им,мн', 'вин,мн', 'род,ед', 'прош,мн,изъяв,сов', 'пр,ед', 'дат,ед'}]]
влажного снега	[['влажный', {'вин,ед', 'род,ед'}], ['снег', {'им,мн', 'вин,мн', 'род,ед'}]]
влажное биенье	[['влажный', {'вин,ед', 'им,ед'}], ['биение', {'вин,ед', 'пр,ед', 'им,ед'}]]
влажной стороной	[['влажный', {'твор,ед', 'пр,ед', 'дат,ед', 'род,ед'}], ['сторона', {'', 'твор,ед'}]]
влажной бумагой	[['влажный', {'твор,ед', 'пр,ед', 'дат,ед', 'род,ед'}], ['бумага', {'твор,ед'}]]
влажную пасть	[['влажный', {'вин,ед'}], ['пасть', {'инф', 'вин,ед', 'им,ед'}]]
влажная саванна	[['влажный', {'им,ед'}], ['саванна', {'им,ед'}]]
влажных повязок	[['влажный', {'вин,мн', 'род,мн', 'пр,мн'}], ['повязка', {'род,мн'}]]
влажные места	[['влажный', {'им,мн', 'вин,мн'}], ['место', {'им,мн', 'вин,мн', 'род,ед'}]]
влажных валков	[['влажный', {'вин,мн', 'род,мн', 'пр,мн'}], ['валок', {'род,мн', 'ед,кр,муж'}]]
влажной травы	[['влажный', {'твор,ед', 'пр,ед', 'дат,ед', 'род,ед'}], ['трава', {'им,мн', 'вин,мн', 'род,ед'}]]
влажная погода	[['влажный', {'им,ед'}], ['погода', {'им,ед'}]]
влажную главу	[['влажный', {'вин,ед'}], ['глава', {'вин,ед'}]]
влажномъ месте	[['влажный', {'пр,ед'}], ['место', {'пр,ед'}]]
влажная жара	[['влажный', {'им,ед'}], ['жара', {'им,ед', 'род,ед'}]]
влажных климатов	[['влажный', {'вин,мн', 'род,мн', 'пр,мн'}], ['климат', {'род,мн'}]]
влажным газом	[['влажный', {'твор,ед', 'дат,мн'}], ['газ', {'твор,ед'}]]
влажной пасты	[['влажный', {'твор,ед', 'пр,ед', 'дат,ед', 'род,ед'}], ['паста', {'им,мн', 'вин,мн', 'род,ед'}]]
влажных предгорьях	[['влажный', {'вин,мн', 'род,мн', 'пр,мн'}], ['предгорие', {'пр,мн'}]]
влажных его	[['влажный', {'вин,мн', 'род,мн', 'пр,мн'}], ['он=SPRO,ед,3-л,муж=вин', {'им,ед,муж', 'род,мн,сред', 'дат,ед,муж', 'дат,ед,сред', 'вин,ед,жен', 'пр,мн', 'вин,мн,од', 'род,мн', 'им,ед,сред', 'вин,ед', 'вин,мн,сред', 'им,ед,жен', 'вин,ед,муж', 'твор,ед,жен', 'дат,мн,муж', 'пр,ед,жен', 'вин,ед,муж,неод', 'вин,мн,муж', 'вин,мн,неод', 'твор,ед,муж', 'дат,мн,сред', 'им,мн', 'пр,мн,сред', 'твор,мн', 'дат,ед,жен', 'пр,мн,муж', 'род,ед,жен', 'твор,ед,сред', 'вин,ед,сред', 'род,ед,муж', 'дат,мн', 'род,ед,сред', 'вин,ед,муж,од', 'пр,ед,муж', 'пр,ед,сред', 'им,мн,сред', 'род,ед', 'твор,мн,сред'}]]
влажное пятно	[['влажный', {'вин,ед', 'им,ед'}], ['пятно', {'вин,ед', 'им,ед'}]]
влажные бока	[['влажный', {'им,мн', 'вин,мн'}], ['бок', {'им,мн', 'вин,мн', 'род,ед'}]]
влажных осадков	[['влажный', {'вин,мн', 'род,мн', 'пр,мн'}], ['осадки', {'род,мн'}]]
влажным куском	[['влажный', {'твор,ед', 'дат,мн'}], ['кусок', {'твор,ед'}]]
влажном слое	[['влажный', {'пр,ед'}], ['слой', {'пр,ед'}]]
влажными глазами	[['влажный', {'твор,мн'}], ['глаз', {'твор,мн'}]]
влажном лете	[['влажный', {'пр,ед'}], ['лето', {'пр,ед'}]]
влажного топлива	[['влажный', {'вин,ед', 'род,ед'}], ['топливо', {'им,мн', 'вин,мн', 'род,ед'}]]
влажное сияние	[['влажный', {'вин,ед', 'им,ед'}], ['сияние', {'вин,ед', 'им,ед'}]]
влажною пустыней	[['влажный', {'твор,ед'}], ['пустыня', {'род,мн', 'твор,ед'}]]
влажную ладошку	[['влажный', {'вин,ед'}], ['ладошка', {'вин,ед'}]]
влажный чуб	[['влажный', {'вин,ед', 'им,ед'}], ['чуб', {'вин,ед', 'дат,мн', 'им,мн', 'вин,мн', 'им,ед', 'твор,мн', 'пр,мн', 'твор,ед', 'род,мн', 'род,ед', 'пр,ед', 'дат,ед'}]]
влажной поволокой	[['влажный', {'твор,ед', 'пр,ед', 'дат,ед', 'род,ед'}], ['поволока', {'твор,ед'}]]
влажную часть	[['влажный', {'вин,ед'}], ['часть', {'вин,ед', 'им,ед'}]]
влажные доски	[['влажный', {'им,мн', 'вин,мн'}], ['доска', {'им,мн', 'вин,мн', 'род,ед'}]]
влажном листе	[['влажный', {'пр,ед'}], ['лист', {'пр,ед'}]]
влажного хлора	[['влажный', {'вин,ед', 'род,ед'}], ['хлор', {'род,ед', 'им,ед'}]]
влажная дезинфекция	[['влажный', {'им,ед'}], ['дезинфекция', {'им,ед'}]]
влажного щебня	[['влажный', {'вин,ед', 'род,ед'}], ['щебень', {'род,ед'}]]
влажной тьмы	[['влажный', {'твор,ед', 'пр,ед', 'дат,ед', 'род,ед'}], ['тьма', {'им,мн', 'вин,мн', 'род,ед'}]]
влажный вариант	[['влажный', {'вин,ед', 'им,ед'}], ['вариант', {'вин,ед', 'им,ед', 'род,мн'}]]
влажных волосах	[['влажный', {'вин,мн', 'род,мн', 'пр,мн'}], ['волос', {'пр,мн'}]]
влажной атмосфере	[['влажный', {'твор,ед', 'пр,ед', 'дат,ед', 'род,ед'}], ['атмосфера', {'пр,ед', 'дат,ед'}]]
влажномъ состоянии	[['влажный', {'пр,ед'}], ['состояние', {'пр,ед'}]]
влажном осадке	[['влажный', {'пр,ед'}], ['осадок', {'пр,ед', 'дат,ед'}]]
влажные луга	[['влажный', {'им,мн', 'вин,мн'}], ['луг', {'им,мн', 'вин,мн', 'род,ед', 'им,ед'}]]
влажным пальцем	[['влажный', {'твор,ед', 'дат,мн'}], ['палец', {'твор,ед'}]]
влажных западинах	[['влажный', {'вин,мн', 'род,мн', 'пр,мн'}], ['западина', {'пр,мн'}]]
влажной пашне	[['влажный', {'твор,ед', 'пр,ед', 'дат,ед', 'род,ед'}], ['пашня', {'пр,ед', 'дат,ед'}]]
влажных газов	[['влажный', {'вин,мн', 'род,мн', 'пр,мн'}], ['газ', {'род,мн', 'ед,кр,муж'}]]
влажную кожу	[['влажный', {'вин,ед'}], ['кожа', {'вин,ед'}]]
влажное марево	[['влажный', {'вин,ед', 'им,ед'}], ['марево', {'вин,ед', 'им,ед', 'ед,кр,сред'}]]
влажный район	[['влажный', {'вин,ед', 'им,ед'}], ['район', {'вин,ед', 'им,ед'}]]
влажных территорий	[['влажный', {'вин,мн', 'род,мн', 'пр,мн'}], ['территория', {'род,мн'}]]
влажное прикосновение	[['влажный', {'вин,ед', 'им,ед'}], ['прикосновение', {'вин,ед', 'им,ед'}]]
влажных стаций	[['влажный', {'вин,мн', 'род,мн', 'пр,мн'}], ['стация', {'род,мн'}]]
влажный горизонт	[['влажный', {'вин,ед', 'им,ед'}], ['горизонт', {'вин,ед', 'им,ед'}]]
влажный взгляд	[['влажный', {'вин,ед', 'им,ед'}], ['взгляд', {'вин,ед', 'им,ед'}]]
влажные усы	[['влажный', {'им,мн', 'вин,мн'}], ['ус', {'им,мн', 'вин,мн', 'род,ед'}]]
влажных порошков	[['влажный', {'вин,мн', 'род,мн', 'пр,мн'}], ['порошок', {'род,мн', 'ед,кр,муж'}]]
влажный флота	[['влажный', {'вин,ед', 'им,ед'}], ['флот', {'им,мн', 'вин,мн', 'род,ед'}]]
влажного прессования	[['влажный', {'вин,ед', 'род,ед'}], ['прессование', {'им,мн', 'вин,мн', 'род,ед'}]]
влажной смесью	[['влажный', {'твор,ед', 'пр,ед', 'дат,ед', 'род,ед'}], ['смесь', {'твор,ед'}]]
влажными сезонами	[['влажный', {'твор,мн'}], ['сезон', {'твор,мн'}]]
влажных смесях	[['влажный', {'вин,мн', 'род,мн', 'пр,мн'}], ['смесь', {'пр,мн'}]]
влажному телу	[['влажный', {'дат,ед'}], ['тело', {'дат,ед'}]]
влажными почвами	[['влажный', {'твор,мн'}], ['почва', {'твор,мн'}]]
влажные препараты	[['влажный', {'им,мн', 'вин,мн'}], ['препарат', {'им,мн', 'вин,мн'}]]
влажную тьму	[['влажный', {'вин,ед'}], ['тьма', {'вин,ед'}]]
влажной ладонью	[['влажный', {'твор,ед', 'пр,ед', 'дат,ед', 'род,ед'}], ['ладонь', {'твор,ед'}]]
влажных аэрозолей	[['влажный', {'вин,мн', 'род,мн', 'пр,мн'}], ['аэрозоль', {'род,мн'}]]
влажного воздуха	[['влажный', {'вин,ед', 'род,ед'}], ['воздух', {'род,ед'}]]
влажному стволу	[['влажный', {'дат,ед'}], ['ствол', {'дат,ед'}]]
влажными камнями	[['влажный', {'твор,мн'}], ['камень', {'твор,мн'}]]
влажных опилках	[['влажный', {'вин,мн', 'род,мн', 'пр,мн'}], ['опилки', {'пр,мн'}]]
влажной древесине	[['влажный', {'твор,ед', 'пр,ед', 'дат,ед', 'род,ед'}], ['древесина', {'пр,ед', 'дат,ед'}]]
влажных руд	[['влажный', {'вин,мн', 'род,мн', 'пр,мн'}], ['руда', {'вин,мн', 'род,мн', 'вин,ед', 'им,ед', 'ед,кр,муж'}]]
влажный отпечаток	[['влажный', {'вин,ед', 'им,ед'}], ['отпечаток', {'вин,ед', 'им,ед'}]]
влажной среде	[['влажный', {'твор,ед', 'пр,ед', 'дат,ед', 'род,ед'}], ['среда', {'пр,ед', 'дат,ед'}]]
влажные предметы	[['влажный', {'им,мн', 'вин,мн'}], ['предмет', {'им,мн', 'вин,мн'}]]
влажный тук	[['влажный', {'вин,ед', 'им,ед'}], ['тук=INTJ=', {'', 'вин,ед', 'им,ед'}]]
влажную подстилку	[['влажный', {'вин,ед'}], ['подстилка', {'вин,ед'}]]
влажном типе	[['влажный', {'пр,ед'}], ['тип', {'пр,ед'}]]
влажное помещение	[['влажный', {'вин,ед', 'им,ед'}], ['помещение', {'вин,ед', 'им,ед'}]]
влажная соль	[['влажный', {'им,ед'}], ['соль', {'вин,ед', 'дат,мн', 'им,мн', 'вин,мн', 'им,ед', 'твор,мн', 'пр,мн', 'твор,ед', 'род,мн', 'род,ед', 'пр,ед', 'дат,ед'}]]
влажный водород	[['влажный', {'вин,ед', 'им,ед'}], ['водород', {'вин,ед', 'им,ед'}]]
влажных областей	[['влажный', {'вин,мн', 'род,мн', 'пр,мн'}], ['область', {'род,мн'}]]
влажному лету	[['влажный', {'дат,ед'}], ['лето', {'местн,ед', 'дат,ед', 'парт,ед'}]]
влажные ее	[['влажный', {'им,мн', 'вин,мн'}], ['она=SPRO,ед,3-л,жен=вин', {'им,ед,муж', 'род,мн,сред', 'дат,ед,муж', 'дат,ед,сред', 'вин,ед,жен', 'пр,мн', 'вин,мн,од', 'род,мн', 'им,ед,сред', 'вин,ед', 'вин,мн,сред', 'им,ед,жен', 'вин,ед,муж', 'твор,ед,жен', 'дат,мн,муж', 'пр,ед,жен', 'вин,ед,муж,неод', 'вин,мн,муж', 'вин,мн,неод', 'твор,ед,муж', 'дат,мн,сред', 'им,мн', 'пр,мн,сред', 'твор,мн', 'дат,ед,жен', 'пр,мн,муж', 'род,ед,жен', 'твор,ед,сред', 'вин,ед,сред', 'род,ед,муж', 'дат,мн', 'род,ед,сред', 'вин,ед,муж,од', 'пр,ед,муж', 'пр,ед,сред', 'им,мн,сред', 'род,ед', 'твор,мн,сред'}]]
влажная почва	[['влажный', {'им,ед'}], ['почва', {'им,ед'}]]
влажного сероводорода	[['влажный', {'вин,ед', 'род,ед'}], ['сероводород', {'род,ед'}]]
влажные земли	[['влажный', {'им,мн', 'вин,мн'}], ['земля', {'им,мн', 'вин,мн', 'род,ед'}]]
влажного табака	[['влажный', {'вин,ед', 'род,ед'}], ['табак', {'вин,ед', 'дат,мн', 'им,мн', 'вин,мн', 'твор,мн', 'им,ед', 'пр,мн', 'твор,ед', 'род,мн', 'род,ед', 'пр,ед', 'дат,ед'}]]
влажной тряпочкой	[['влажный', {'твор,ед', 'пр,ед', 'дат,ед', 'род,ед'}], ['тряпочка', {'твор,ед'}]]
влажная темнота	[['влажный', {'им,ед'}], ['темнота', {'им,ед'}]]
влажную духоту	[['влажный', {'вин,ед'}], ['духота', {'вин,ед'}]]
влажным листом	[['влажный', {'твор,ед', 'дат,мн'}], ['лист', {'твор,ед'}]]
влажные носы	[['влажный', {'им,мн', 'вин,мн'}], ['нос', {'им,мн', 'вин,мн'}]]
влажной чернотой	[['влажный', {'твор,ед', 'пр,ед', 'дат,ед', 'род,ед'}], ['чернота', {'твор,ед'}]]
влажные тропики	[['влажный', {'им,мн', 'вин,мн'}], ['тропики', {'им,мн', 'вин,мн'}]]
влажные перила	[['влажный', {'им,мн', 'вин,мн'}], ['перила', {'им,мн', 'вин,мн'}]]
влажный налет	[['влажный', {'вин,ед', 'им,ед'}], ['налет', {'вин,ед', 'им,ед'}]]
влажные области	[['влажный', {'им,мн', 'вин,мн'}], ['область', {'им,мн', 'вин,мн', 'пр,ед', 'дат,ед', 'род,ед'}]]
влажным сезоном	[['влажный', {'твор,ед', 'дат,мн'}], ['сезон', {'твор,ед'}]]
влажные ветви	[['влажный', {'им,мн', 'вин,мн'}], ['ветвь', {'им,мн', 'вин,мн', 'пр,ед', 'дат,ед', 'род,ед'}]]
влажной материи	[['влажный', {'твор,ед', 'пр,ед', 'дат,ед', 'род,ед'}], ['материя', {'им,мн', 'вин,мн', 'пр,ед', 'дат,ед', 'род,ед'}]]
влажных камерах	[['влажный', {'вин,мн', 'род,мн', 'пр,мн'}], ['камера', {'пр,мн'}]]
влажную уборку	[['влажный', {'вин,ед'}], ['уборка', {'вин,ед'}]]
влажные листочки	[['влажный', {'им,мн', 'вин,мн'}], ['листочек', {'им,мн', 'вин,мн'}]]
влажные веки	[['влажный', {'им,мн', 'вин,мн'}], ['веко', {'им,мн', 'вин,мн'}]]
влажной бумаги	[['влажный', {'твор,ед', 'пр,ед', 'дат,ед', 'род,ед'}], ['бумага', {'им,мн', 'вин,мн', 'род,ед'}]]
влажных типов	[['влажный', {'вин,мн', 'род,мн', 'пр,мн'}], ['тип', {'род,мн', 'вин,мн'}]]
влажной массой	[['влажный', {'твор,ед', 'пр,ед', 'дат,ед', 'род,ед'}], ['масса', {'твор,ед'}]]
влажную свежесть	[['влажный', {'вин,ед'}], ['свежесть', {'вин,ед', 'им,ед'}]]
влажного эфира	[['влажный', {'вин,ед', 'род,ед'}], ['эфир', {'род,ед'}]]
влажной марлей	[['влажный', {'твор,ед', 'пр,ед', 'дат,ед', 'род,ед'}], ['марля', {'род,мн', 'твор,ед'}]]
влажный периоды	[['влажный', {'вин,ед', 'им,ед'}], ['период', {'им,мн', 'вин,мн'}]]
влажного жара	[['влажный', {'вин,ед', 'род,ед'}], ['жара', {'им,ед', 'род,ед'}]]
влажной синеве	[['влажный', {'твор,ед', 'пр,ед', 'дат,ед', 'род,ед'}], ['синева', {'пр,ед', 'дат,ед'}]]
влажного осаждения	[['влажный', {'вин,ед', 'род,ед'}], ['осаждение', {'им,мн', 'вин,мн', 'род,ед'}]]
влажные территории	[['влажный', {'им,мн', 'вин,мн'}], ['территория', {'им,мн', 'вин,мн', 'пр,ед', 'дат,ед', 'род,ед'}]]
влажной лесостепи	[['влажный', {'твор,ед', 'пр,ед', 'дат,ед', 'род,ед'}], ['лесостепь', {'им,мн', 'вин,мн', 'пр,ед', 'дат,ед', 'род,ед'}]]
влажное долин	[['влажный', {'вин,ед', 'им,ед'}], ['долина', {'род,мн', 'им,ед'}]]
влажного газа	[['влажный', {'вин,ед', 'род,ед'}], ['газ', {'вин,ед', 'им,ед', 'твор,ед', 'род,ед', 'пр,ед', 'дат,ед'}]]
влажных кудрей	[['влажный', {'вин,мн', 'род,мн', 'пр,мн'}], ['кудри', {'род,мн'}]]
влажных зонах	[['влажный', {'вин,мн', 'род,мн', 'пр,мн'}], ['зона', {'пр,мн'}]]
влажных сумерках	[['влажный', {'вин,мн', 'род,мн', 'пр,мн'}], ['сумерки', {'пр,мн'}]]
влажному слою	[['влажный', {'дат,ед'}], ['слой', {'непрош,ед,изъяв,1-л', 'дат,ед'}]]
влажный огонь	[['влажный', {'вин,ед', 'им,ед'}], ['огонь', {'вин,ед', 'им,ед'}]]
влажными ветрами	[['влажный', {'твор,мн'}], ['ветер', {'твор,мн'}]]
влажную прохладу	[['влажный', {'вин,ед'}], ['прохлада', {'вин,ед'}]]
влажными тряпками	[['влажный', {'твор,мн'}], ['тряпка', {'твор,мн'}]]
влажная тундра	[['влажный', {'им,ед'}], ['тундра', {'им,ед'}]]
влажные камеры	[['влажный', {'им,мн', 'вин,мн'}], ['камера', {'им,мн', 'вин,мн', 'род,ед'}]]
влажным губам	[['влажный', {'твор,ед', 'дат,мн'}], ['губа', {'дат,мн'}]]
влажный шорох	[['влажный', {'вин,ед', 'им,ед'}], ['шорох', {'вин,ед', 'им,ед'}]]
влажным скалам	[['влажный', {'твор,ед', 'дат,мн'}], ['скала', {'дат,мн'}]]
влажные кудри	[['влажный', {'им,мн', 'вин,мн'}], ['кудри', {'им,мн', 'вин,мн'}]]
влажных условиях	[['влажный', {'вин,мн', 'род,мн', 'пр,мн'}], ['условие', {'пр,мн'}]]
влажным взором	[['влажный', {'твор,ед', 'дат,мн'}], ['взор', {'твор,ед'}]]
влажных вариантах	[['влажный', {'вин,мн', 'род,мн', 'пр,мн'}], ['вариант', {'пр,мн'}]]
влажной тундре	[['влажный', {'твор,ед', 'пр,ед', 'дат,ед', 'род,ед'}], ['тундра', {'пр,ед', 'дат,ед'}]]
влажный дефицит	[['влажный', {'вин,ед', 'им,ед'}], ['дефицит', {'вин,ед', 'им,ед'}]]
влажными грунтами	[['влажный', {'твор,мн'}], ['грунт', {'твор,мн'}]]
влажных топлив	[['влажный', {'вин,мн', 'род,мн', 'пр,мн'}], ['топливо', {'род,мн'}]]
влажному мху	[['влажный', {'дат,ед'}], ['мох', {'местн,ед', 'дат,ед', 'парт,ед'}]]
влажные весны	[['влажный', {'им,мн', 'вин,мн'}], ['весна', {'им,мн', 'вин,мн', 'род,ед'}]]
влажные гранки	[['влажный', {'им,мн', 'вин,мн'}], ['гранка', {'им,мн', 'вин,мн', 'род,ед'}]]
влажный луч	[['влажный', {'вин,ед', 'им,ед'}], ['луч', {'вин,ед', 'им,ед'}]]
влажным стенкам	[['влажный', {'твор,ед', 'дат,мн'}], ['стенка', {'дат,мн'}]]
влажную мешанку	[['влажный', {'вин,ед'}], ['мешанка', {'вин,ед'}]]
влажных областях	[['влажный', {'вин,мн', 'род,мн', 'пр,мн'}], ['область', {'пр,мн'}]]
влажные фазы	[['влажный', {'им,мн', 'вин,мн'}], ['фаза', {'им,мн', 'вин,мн', 'род,ед'}]]
влажной дорогой	[['влажный', {'твор,ед', 'пр,ед', 'дат,ед', 'род,ед'}], ['дорогой=A=вин,ед,полн,муж,неод', {'вин,ед,полн,муж,неод', 'твор,ед,полн,жен', 'род,ед,полн,жен', 'им,ед', 'дат,ед,полн,жен', 'твор,ед', 'им,ед,полн,муж', 'пр,ед,полн,жен'}]]
влажный годы	[['влажный', {'вин,ед', 'им,ед'}], ['год', {'им,мн', 'вин,мн'}]]
влажным пятном	[['влажный', {'твор,ед', 'дат,мн'}], ['пятно', {'твор,ед'}]]
влажного азота	[['влажный', {'вин,ед', 'род,ед'}], ['азот', {'род,ед'}]]
влажную розу	[['влажный', {'вин,ед'}], ['роза', {'вин,ед'}]]
влажных суглинках	[['влажный', {'вин,мн', 'род,мн', 'пр,мн'}], ['суглинок', {'пр,мн'}]]
влажным слоем	[['влажный', {'твор,ед', 'дат,мн'}], ['слой', {'твор,ед'}]]
влажной ватой	[['влажный', {'твор,ед', 'пр,ед', 'дат,ед', 'род,ед'}], ['вата', {'твор,ед'}]]
влажной тряпицей	[['влажный', {'твор,ед', 'пр,ед', 'дат,ед', 'род,ед'}], ['тряпица', {'твор,ед'}]]
влажным месяцем	[['влажный', {'твор,ед', 'дат,мн'}], ['месяц', {'твор,ед'}]]
влажного микроклимата	[['влажный', {'вин,ед', 'род,ед'}], ['микроклимат', {'род,ед'}]]
влажный ветеръ	[['влажный', {'вин,ед', 'им,ед'}], ['ветер', {'вин,ед', 'им,ед'}]]
влажных саванн	[['влажный', {'вин,мн', 'род,мн', 'пр,мн'}], ['саванна', {'род,мн'}]]
влажного дерева	[['влажный', {'вин,ед', 'род,ед'}], ['дерево', {'им,мн', 'вин,мн', 'род,ед'}]]
влажный песок	[['влажный', {'вин,ед', 'им,ед'}], ['песок', {'вин,ед', 'им,ед'}]]
влажные рельсы	[['влажный', {'им,мн', 'вин,мн'}], ['рельс', {'им,мн', 'вин,мн'}]]
влажных гор	[['влажный', {'вин,мн', 'род,мн', 'пр,мн'}], ['гора', {'вин,ед', 'дат,мн', 'им,мн', 'вин,мн', 'им,ед', 'твор,мн', 'пр,мн', 'твор,ед', 'род,мн', 'род,ед', 'пр,ед', 'дат,ед'}]]
влажный тампон	[['влажный', {'вин,ед', 'им,ед'}], ['тампон', {'вин,ед', 'им,ед'}]]
влажном взгляде	[['влажный', {'пр,ед'}], ['взгляд', {'пр,ед'}]]
влажное утро	[['влажный', {'вин,ед', 'им,ед'}], ['утро', {'вин,ед', 'им,ед'}]]
влажными устами	[['влажный', {'твор,мн'}], ['уста', {'твор,мн'}]]
влажном году	[['влажный', {'пр,ед'}], ['год', {'местн,ед', 'дат,ед'}]]
влажную шерсть	[['влажный', {'вин,ед'}], ['шерсть', {'вин,ед', 'им,ед'}]]
влажные части	[['влажный', {'им,мн', 'вин,мн'}], ['часть', {'им,мн', 'вин,мн', 'род,ед', 'пр,ед', 'дат,ед', 'ед,пов,2-л'}]]
влажной прохлады	[['влажный', {'твор,ед', 'пр,ед', 'дат,ед', 'род,ед'}], ['прохлада', {'им,мн', 'вин,мн', 'род,ед'}]]
влажном образце	[['влажный', {'пр,ед'}], ['образец', {'пр,ед'}]]
влажный шелест	[['влажный', {'вин,ед', 'им,ед'}], ['шелест', {'вин,ед', 'им,ед'}]]
влажном камне	[['влажный', {'пр,ед'}], ['камень', {'пр,ед'}]]
влажных мешанок	[['влажный', {'вин,мн', 'род,мн', 'пр,мн'}], ['мешанка', {'род,мн'}]]
влажные нити	[['влажный', {'им,мн', 'вин,мн'}], ['нить', {'им,мн', 'вин,мн', 'пр,ед', 'дат,ед', 'род,ед'}]]
влажной груди	[['влажный', {'твор,ед', 'пр,ед', 'дат,ед', 'род,ед'}], ['грудь', {'им,мн', 'вин,мн', 'пр,ед', 'дат,ед', 'род,ед'}]]
влажным низинам	[['влажный', {'твор,ед', 'дат,мн'}], ['низина', {'дат,мн'}]]
влажную тишину	[['влажный', {'вин,ед'}], ['тишина', {'вин,ед', 'дат,ед'}]]
влажным хлором	[['влажный', {'твор,ед', 'дат,мн'}], ['хлор', {'твор,ед'}]]
влажная стезя	[['влажный', {'им,ед'}], ['стезя', {'им,ед'}]]
влажных фаз	[['влажный', {'вин,мн', 'род,мн', 'пр,мн'}], ['фаза', {'род,мн'}]]
влажными глаза	[['влажный', {'твор,мн'}], ['глаз', {'им,мн', 'вин,мн', 'род,ед'}]]
влажным асфальтом	[['влажный', {'твор,ед', 'дат,мн'}], ['асфальт', {'твор,ед'}]]
влажную даль	[['влажный', {'вин,ед'}], ['даль', {'вин,ед', 'дат,мн', 'им,мн', 'вин,мн', 'им,ед', 'твор,мн', 'пр,мн', 'твор,ед', 'род,мн', 'род,ед', 'пр,ед', 'дат,ед'}]]
влажными прядями	[['влажный', {'твор,мн'}], ['прядь', {'твор,мн'}]]
влажную бумагу	[['влажный', {'вин,ед'}], ['бумага', {'вин,ед'}]]
влажном дне	[['влажный', {'пр,ед'}], ['день', {'пр,ед'}]]
влажных ее	[['влажный', {'вин,мн', 'род,мн', 'пр,мн'}], ['она=SPRO,ед,3-л,жен=вин', {'им,ед,муж', 'род,мн,сред', 'дат,ед,муж', 'дат,ед,сред', 'вин,ед,жен', 'пр,мн', 'вин,мн,од', 'род,мн', 'им,ед,сред', 'вин,ед', 'вин,мн,сред', 'им,ед,жен', 'вин,ед,муж', 'твор,ед,жен', 'дат,мн,муж', 'пр,ед,жен', 'вин,ед,муж,неод', 'вин,мн,муж', 'вин,мн,неод', 'твор,ед,муж', 'дат,мн,сред', 'им,мн', 'пр,мн,сред', 'твор,мн', 'дат,ед,жен', 'пр,мн,муж', 'род,ед,жен', 'твор,ед,сред', 'вин,ед,сред', 'род,ед,муж', 'дат,мн', 'род,ед,сред', 'вин,ед,муж,од', 'пр,ед,муж', 'пр,ед,сред', 'им,мн,сред', 'род,ед', 'твор,мн,сред'}]]
влажной жары	[['влажный', {'твор,ед', 'пр,ед', 'дат,ед', 'род,ед'}], ['жара', {'им,мн', 'вин,мн', 'род,ед'}]]
влажных годов	[['влажный', {'вин,мн', 'род,мн', 'пр,мн'}], ['год', {'род,мн'}]]
влажная весна	[['влажный', {'им,ед'}], ['весна', {'им,ед'}]]
влажному стеклу	[['влажный', {'дат,ед'}], ['стекло', {'дат,ед'}]]
влажные повязки	[['влажный', {'им,мн', 'вин,мн'}], ['повязка', {'им,мн', 'вин,мн', 'род,ед'}]]
влажные дорожки	[['влажный', {'им,мн', 'вин,мн'}], ['дорожка', {'им,мн', 'вин,мн', 'род,ед'}]]
влажные отблески	[['влажный', {'им,мн', 'вин,мн'}], ['отблеск', {'им,мн', 'вин,мн'}]]
влажной борозде	[['влажный', {'твор,ед', 'пр,ед', 'дат,ед', 'род,ед'}], ['борозда', {'пр,ед', 'дат,ед'}]]
влажный глаз	[['влажный', {'вин,ед', 'им,ед'}], ['глаз', {'вин,ед', 'род,мн', 'им,ед'}]]
влажный туманъ	[['влажный', {'вин,ед', 'им,ед'}], ['туман', {'вин,ед', 'им,ед'}]]
влажным материалом	[['влажный', {'твор,ед', 'дат,мн'}], ['материал', {'твор,ед'}]]
влажную скамейку	[['влажный', {'вин,ед'}], ['скамейка', {'вин,ед'}]]
влажной прелью	[['влажный', {'твор,ед', 'пр,ед', 'дат,ед', 'род,ед'}], ['прель', {'твор,ед'}]]
влажного участка	[['влажный', {'вин,ед', 'род,ед'}], ['участок', {'род,ед'}]]
влажными главами	[['влажный', {'твор,мн'}], ['глава', {'твор,мн'}]]
влажное стекло	[['влажный', {'вин,ед', 'им,ед'}], ['стекло', {'вин,ед', 'им,ед', 'прош,ед,изъяв,сред,сов'}]]
влажного лба	[['влажный', {'вин,ед', 'род,ед'}], ['лоб', {'род,ед'}]]
влажными ветвями	[['влажный', {'твор,мн'}], ['ветвь', {'твор,мн'}]]
влажным биотопам	[['влажный', {'твор,ед', 'дат,мн'}], ['биотоп', {'дат,мн'}]]
влажных равнинах	[['влажный', {'вин,мн', 'род,мн', 'пр,мн'}], ['равнина', {'пр,мн'}]]
влажными розами	[['влажный', {'твор,мн'}], ['роза', {'твор,мн'}]]
влажном хранении	[['влажный', {'пр,ед'}], ['хранение', {'пр,ед'}]]
влажных условий	[['влажный', {'вин,мн', 'род,мн', 'пр,мн'}], ['условие', {'род,мн'}]]
влажный препарат	[['влажный', {'вин,ед', 'им,ед'}], ['препарат', {'вин,ед', 'им,ед'}]]
влажный туман	[['влажный', {'вин,ед', 'им,ед'}], ['туман', {'вин,ед', 'им,ед'}]]
влажной солью	[['влажный', {'твор,ед', 'пр,ед', 'дат,ед', 'род,ед'}], ['соль', {'непрош,ед,изъяв,1-л,сов', 'твор,ед'}]]
влажный песокъ	[['влажный', {'вин,ед', 'им,ед'}], ['песок', {'вин,ед', 'им,ед'}]]
влажной прохладе	[['влажный', {'твор,ед', 'пр,ед', 'дат,ед', 'род,ед'}], ['прохлада', {'пр,ед', 'дат,ед'}]]
влажным дыханьем	[['влажный', {'твор,ед', 'дат,мн'}], ['дыхание', {'твор,ед'}]]
влажной ее	[['влажный', {'твор,ед', 'пр,ед', 'дат,ед', 'род,ед'}], ['она=SPRO,ед,3-л,жен=вин', {'им,ед,муж', 'род,мн,сред', 'дат,ед,муж', 'дат,ед,сред', 'вин,ед,жен', 'пр,мн', 'вин,мн,од', 'род,мн', 'им,ед,сред', 'вин,ед', 'вин,мн,сред', 'им,ед,жен', 'вин,ед,муж', 'твор,ед,жен', 'дат,мн,муж', 'пр,ед,жен', 'вин,ед,муж,неод', 'вин,мн,муж', 'вин,мн,неод', 'твор,ед,муж', 'дат,мн,сред', 'им,мн', 'пр,мн,сред', 'твор,мн', 'дат,ед,жен', 'пр,мн,муж', 'род,ед,жен', 'твор,ед,сред', 'вин,ед,сред', 'род,ед,муж', 'дат,мн', 'род,ед,сред', 'вин,ед,муж,од', 'пр,ед,муж', 'пр,ед,сред', 'им,мн,сред', 'род,ед', 'твор,мн,сред'}]]
влажном ветру	[['влажный', {'пр,ед'}], ['ветер', {'местн,ед', 'дат,ед'}]]
влажной коры	[['влажный', {'твор,ед', 'пр,ед', 'дат,ед', 'род,ед'}], ['кора', {'род,ед'}]]
влажный воз	[['влажный', {'вин,ед', 'им,ед'}], ['воз', {'вин,ед', 'им,ед'}]]
влажная порфира	[['влажный', {'им,ед'}], ['порфира', {'вин,ед', 'им,ед', 'род,ед'}]]
влажные пески	[['влажный', {'им,мн', 'вин,мн'}], ['песок', {'им,мн', 'вин,мн'}]]
влажных облаков	[['влажный', {'вин,мн', 'род,мн', 'пр,мн'}], ['облако', {'род,мн'}]]
влажном режиме	[['влажный', {'пр,ед'}], ['режим', {'пр,ед'}]]
влажным склонам	[['влажный', {'твор,ед', 'дат,мн'}], ['склон', {'дат,мн'}]]
влажных ресниц	[['влажный', {'вин,мн', 'род,мн', 'пр,мн'}], ['ресница', {'род,мн'}]]
влажном участке	[['влажный', {'пр,ед'}], ['участок', {'пр,ед'}]]
влажный пояс	[['влажный', {'вин,ед', 'им,ед'}], ['пояс', {'вин,ед', 'им,ед'}]]
влажной губки	[['влажный', {'твор,ед', 'пр,ед', 'дат,ед', 'род,ед'}], ['губка', {'им,мн', 'вин,мн', 'род,ед'}]]
влажными листьями	[['влажный', {'твор,мн'}], ['лист', {'твор,мн'}]]
влажные пятна	[['влажный', {'им,мн', 'вин,мн'}], ['пятно', {'им,мн', 'вин,мн', 'род,ед'}]]
влажные пласты	[['влажный', {'им,мн', 'вин,мн'}], ['пласт', {'им,мн', 'вин,мн'}]]
влажного района	[['влажный', {'вин,ед', 'род,ед'}], ['район', {'род,ед'}]]
влажной дороге	[['влажный', {'твор,ед', 'пр,ед', 'дат,ед', 'род,ед'}], ['дорога', {'пр,ед', 'дат,ед'}]]
влажную погоду	[['влажный', {'вин,ед'}], ['погода', {'вин,ед'}]]
влажным сезонами	[['влажный', {'твор,ед', 'дат,мн'}], ['сезон', {'твор,мн'}]]
влажном помещении	[['влажный', {'пр,ед'}], ['помещение', {'пр,ед'}]]
влажных эпох	[['влажный', {'вин,мн', 'род,мн', 'пр,мн'}], ['эпоха', {'род,мн'}]]
влажных районов	[['влажный', {'вин,мн', 'род,мн', 'пр,мн'}], ['район', {'род,мн'}]]
влажным местообитаниям	[['влажный', {'твор,ед', 'дат,мн'}], ['местообитание', {'дат,мн'}]]
влажной мордой	[['влажный', {'твор,ед', 'пр,ед', 'дат,ед', 'род,ед'}], ['морда', {'твор,ед'}]]
влажный покров	[['влажный', {'вин,ед', 'им,ед'}], ['покров', {'вин,ед', 'им,ед'}]]
влажное дыхание	[['влажный', {'вин,ед', 'им,ед'}], ['дыхание', {'вин,ед', 'им,ед'}]]
влажный ветерок	[['влажный', {'вин,ед', 'им,ед'}], ['ветерок', {'вин,ед', 'им,ед'}]]
влажные ресницы	[['влажный', {'им,мн', 'вин,мн'}], ['ресница', {'им,мн', 'вин,мн', 'род,ед'}]]
влажному сезону	[['влажный', {'дат,ед'}], ['сезон', {'дат,ед'}]]
влажная лягушка	[['влажный', {'им,ед'}], ['лягушка', {'им,ед'}]]
влажной пеленой	[['влажный', {'твор,ед', 'пр,ед', 'дат,ед', 'род,ед'}], ['пелена', {'твор,ед'}]]
влажный платок	[['влажный', {'вин,ед', 'им,ед'}], ['платок', {'вин,ед', 'им,ед'}]]
влажной тьме	[['влажный', {'твор,ед', 'пр,ед', 'дат,ед', 'род,ед'}], ['тьма', {'пр,ед', 'дат,ед'}]]
влажных препаратов	[['влажный', {'вин,мн', 'род,мн', 'пр,мн'}], ['препарат', {'род,мн'}]]
влажных боров	[['влажный', {'вин,мн', 'род,мн', 'пр,мн'}], ['боров', {'род,мн', 'им,ед', 'вин,ед'}]]
влажного грунта	[['влажный', {'вин,ед', 'род,ед'}], ['грунт', {'род,ед'}]]
влажного некроза	[['влажный', {'вин,ед', 'род,ед'}], ['некроз', {'род,ед'}]]
влажная теплота	[['влажный', {'им,ед'}], ['теплота', {'им,ед'}]]
влажные долины	[['влажный', {'им,мн', 'вин,мн'}], ['долина', {'им,мн', 'вин,мн', 'род,ед'}]]
влажной дымкой	[['влажный', {'твор,ед', 'пр,ед', 'дат,ед', 'род,ед'}], ['дымка', {'твор,ед'}]]
влажных помещений	[['влажный', {'вин,мн', 'род,мн', 'пр,мн'}], ['помещение', {'род,мн'}]]
влажных сезонов	[['влажный', {'вин,мн', 'род,мн', 'пр,мн'}], ['сезон', {'род,мн'}]]
влажными кормами	[['влажный', {'твор,мн'}], ['корм', {'твор,мн'}]]
влажной тряпкой	[['влажный', {'твор,ед', 'пр,ед', 'дат,ед', 'род,ед'}], ['тряпка', {'твор,ед'}]]
влажных местообитаний	[['влажный', {'вин,мн', 'род,мн', 'пр,мн'}], ['местообитание', {'род,мн'}]]
влажного ветра	[['влажный', {'вин,ед', 'род,ед'}], ['ветер', {'им,мн', 'вин,мн', 'род,ед'}]]
влажные выпадения	[['влажный', {'им,мн', 'вин,мн'}], ['выпадение', {'им,мн', 'вин,мн', 'род,ед'}]]
влажным носом	[['влажный', {'твор,ед', 'дат,мн'}], ['нос', {'твор,ед'}]]
влажную стихию	[['влажный', {'вин,ед'}], ['стихия', {'вин,ед'}]]
влажном шуме	[['влажный', {'пр,ед'}], ['шум', {'пр,ед'}]]
влажный эфир	[['влажный', {'вин,ед', 'им,ед'}], ['эфир', {'вин,ед', 'им,ед'}]]
влажной погодой	[['влажный', {'твор,ед', 'пр,ед', 'дат,ед', 'род,ед'}], ['погода', {'твор,ед'}]]
влажных понижениях	[['влажный', {'вин,мн', 'род,мн', 'пр,мн'}], ['понижение', {'пр,мн'}]]
влажных травах	[['влажный', {'вин,мн', 'род,мн', 'пр,мн'}], ['трава', {'пр,мн'}]]
влажный язык	[['влажный', {'вин,ед', 'им,ед'}], ['язык', {'вин,ед', 'им,ед'}]]
влажному весу	[['влажный', {'дат,ед'}], ['вес', {'дат,ед', 'парт,ед'}]]
влажной спиной	[['влажный', {'твор,ед', 'пр,ед', 'дат,ед', 'род,ед'}], ['спина', {'твор,ед'}]]
влажной среды	[['влажный', {'твор,ед', 'пр,ед', 'дат,ед', 'род,ед'}], ['среда', {'им,мн', 'вин,мн', 'род,ед'}]]
влажную полосу	[['влажный', {'вин,ед'}], ['полоса', {'вин,ед'}]]
влажной глиной	[['влажный', {'твор,ед', 'пр,ед', 'дат,ед', 'род,ед'}], ['глина', {'твор,ед'}]]
влажного варианта	[['влажный', {'вин,ед', 'род,ед'}], ['вариант', {'род,ед', 'им,ед'}]]
влажное хранение	[['влажный', {'вин,ед', 'им,ед'}], ['хранение', {'вин,ед', 'им,ед'}]]
влажную тень	[['влажный', {'вин,ед'}], ['тень', {'вин,ед', 'им,ед'}]]
влажные поля	[['влажный', {'им,мн', 'вин,мн'}], ['поле', {'вин,ед', 'им,мн', 'вин,мн', 'им,ед', 'непрош,деепр', 'род,ед'}]]
влажный шепот	[['влажный', {'вин,ед', 'им,ед'}], ['шепот', {'вин,ед', 'им,ед'}]]
влажной эпохи	[['влажный', {'твор,ед', 'пр,ед', 'дат,ед', 'род,ед'}], ['эпоха', {'им,мн', 'вин,мн', 'род,ед'}]]
влажной печалью	[['влажный', {'твор,ед', 'пр,ед', 'дат,ед', 'род,ед'}], ['печаль', {'твор,ед'}]]
влажное горение	[['влажный', {'вин,ед', 'им,ед'}], ['горение', {'вин,ед', 'им,ед'}]]
влажныя земли	[['влажный', {'устар,вин', 'устар,им'}], ['земля', {'им,мн', 'вин,мн', 'род,ед'}]]
влажные камни	[['влажный', {'им,мн', 'вин,мн'}], ['камень', {'им,мн', 'вин,мн'}]]
влажным голосом	[['влажный', {'твор,ед', 'дат,мн'}], ['голос', {'твор,ед'}]]
влажный голос	[['влажный', {'вин,ед', 'им,ед'}], ['голос', {'вин,ед', 'им,ед'}]]
влажном поле	[['влажный', {'пр,ед'}], ['поле', {'вин,ед', 'пр,ед', 'им,ед', 'дат,ед'}]]
влажных компрессов	[['влажный', {'вин,мн', 'род,мн', 'пр,мн'}], ['компресс', {'род,мн'}]]
влажная зелень	[['влажный', {'им,ед'}], ['зелень', {'вин,ед', 'им,ед'}]]
влажной погоды	[['влажный', {'твор,ед', 'пр,ед', 'дат,ед', 'род,ед'}], ['погода', {'им,мн', 'вин,мн', 'род,ед'}]]
влажное сукно	[['влажный', {'вин,ед', 'им,ед'}], ['сукно', {'вин,ед', 'им,ед'}]]
влажную листву	[['влажный', {'вин,ед'}], ['листва', {'вин,ед'}]]
влажных губ	[['влажный', {'вин,мн', 'род,мн', 'пр,мн'}], ['губа', {'род,мн'}]]
влажное полотно	[['влажный', {'вин,ед', 'им,ед'}], ['полотно', {'вин,ед', 'им,ед'}]]
влажного полотна	[['влажный', {'вин,ед', 'род,ед'}], ['полотно', {'им,мн', 'вин,мн', 'род,ед'}]]
влажного ила	[['влажный', {'вин,ед', 'род,ед'}], ['ил', {'род,ед'}]]
влажного способа	[['влажный', {'вин,ед', 'род,ед'}], ['способ', {'род,ед'}]]
влажной белизной	[['влажный', {'твор,ед', 'пр,ед', 'дат,ед', 'род,ед'}], ['белизна', {'твор,ед'}]]
влажных осыпях	[['влажный', {'вин,мн', 'род,мн', 'пр,мн'}], ['осыпь', {'пр,мн'}]]
влажных опилок	[['влажный', {'вин,мн', 'род,мн', 'пр,мн'}], ['опилки', {'род,мн'}]]
влажное пространство	[['влажный', {'вин,ед', 'им,ед'}], ['пространство', {'вин,ед', 'им,ед'}]]
влажной щеткой	[['влажный', {'твор,ед', 'пр,ед', 'дат,ед', 'род,ед'}], ['щетка', {'твор,ед'}]]
влажную гальку	[['влажный', {'вин,ед'}], ['галька', {'вин,ед', 'дат,ед'}]]
влажным углем	[['влажный', {'твор,ед', 'дат,мн'}], ['уголь', {'твор,ед'}]]
влажные губы	[['влажный', {'им,мн', 'вин,мн'}], ['губа', {'им,мн', 'вин,мн', 'род,ед'}]]
влажную рубашку	[['влажный', {'вин,ед'}], ['рубашка', {'вин,ед'}]]
влажный климат	[['влажный', {'вин,ед', 'им,ед'}], ['климат', {'вин,ед', 'им,ед'}]]
влажных равнин	[['влажный', {'вин,мн', 'род,мн', 'пр,мн'}], ['равнина', {'род,мн'}]]
влажным зерном	[['влажный', {'твор,ед', 'дат,мн'}], ['зерно', {'твор,ед'}]]
влажную пыль	[['влажный', {'вин,ед'}], ['пыль', {'вин,ед', 'им,ед'}]]
влажную марлю	[['влажный', {'вин,ед'}], ['марля', {'вин,ед'}]]
влажное зерно	[['влажный', {'вин,ед', 'им,ед'}], ['зерно', {'вин,ед', 'им,ед'}]]
влажную темноту	[['влажный', {'вин,ед'}], ['темнота', {'вин,ед'}]]
влажной щеке	[['влажный', {'твор,ед', 'пр,ед', 'дат,ед', 'род,ед'}], ['щека', {'пр,ед', 'дат,ед'}]]
влажной черноте	[['влажный', {'твор,ед', 'пр,ед', 'дат,ед', 'род,ед'}], ['чернота', {'пр,ед', 'дат,ед'}]]
влажными лесами	[['влажный', {'твор,мн'}], ['лес', {'твор,мн'}]]
влажной щекой	[['влажный', {'твор,ед', 'пр,ед', 'дат,ед', 'род,ед'}], ['щека', {'твор,ед'}]]
влажном хлоре	[['влажный', {'пр,ед'}], ['хлор', {'пр,ед', 'дат,ед'}]]
влажного водорода	[['влажный', {'вин,ед', 'род,ед'}], ['водород', {'род,ед'}]]
влажных нимф	[['влажный', {'вин,мн', 'род,мн', 'пр,мн'}], ['нимфа', {'вин,мн', 'род,мн'}]]
влажному лбу	[['влажный', {'дат,ед'}], ['лоб', {'местн,ед', 'дат,ед'}]]
влажное облако	[['влажный', {'вин,ед', 'им,ед'}], ['облако', {'вин,ед', 'им,ед'}]]
влажная адиабата	[['влажный', {'им,ед'}], ['адиабата', {'им,ед'}]]
влажной руки	[['влажный', {'твор,ед', 'пр,ед', 'дат,ед', 'род,ед'}], ['рука', {'им,мн', 'вин,мн', 'род,ед'}]]
влажных степей	[['влажный', {'вин,мн', 'род,мн', 'пр,мн'}], ['степь', {'род,мн'}]]
влажному материалу	[['влажный', {'дат,ед'}], ['материал', {'дат,ед', 'парт,ед'}]]
влажному столбу	[['влажный', {'дат,ед'}], ['столб', {'дат,ед'}]]
влажный висок	[['влажный', {'вин,ед', 'им,ед'}], ['висок', {'вин,ед', 'им,ед', 'род,мн'}]]
влажных кормах	[['влажный', {'вин,мн', 'род,мн', 'пр,мн'}], ['корма', {'пр,мн'}]]
влажная тишина	[['влажный', {'им,ед'}], ['тишина', {'вин,ед', 'им,ед', 'род,ед'}]]
влажный период	[['влажный', {'вин,ед', 'им,ед'}], ['период', {'вин,ед', 'им,ед'}]]
влажным ущельям	[['влажный', {'твор,ед', 'дат,мн'}], ['ущелие', {'дат,мн'}]]
влажную фазу	[['влажный', {'вин,ед'}], ['фаза', {'вин,ед'}]]
влажный кусок	[['влажный', {'вин,ед', 'им,ед'}], ['кусок', {'вин,ед', 'им,ед'}]]
влажные пробы	[['влажный', {'им,мн', 'вин,мн'}], ['проба', {'им,мн', 'вин,мн', 'род,ед'}]]
влажного леса	[['влажный', {'вин,ед', 'род,ед'}], ['лес', {'им,мн', 'вин,мн', 'род,ед', 'им,ед'}]]
влажные семена	[['влажный', {'им,мн', 'вин,мн'}], ['семя', {'им,мн', 'вин,мн', 'вин,ед', 'род,ед'}]]
влажного термометров	[['влажный', {'вин,ед', 'род,ед'}], ['термометр', {'род,мн'}]]
влажным стенам	[['влажный', {'твор,ед', 'дат,мн'}], ['стена', {'дат,мн'}]]
влажные материалы	[['влажный', {'им,мн', 'вин,мн'}], ['материал', {'им,мн', 'вин,мн'}]]
влажный участок	[['влажный', {'вин,ед', 'им,ед'}], ['участок', {'вин,ед', 'им,ед'}]]
влажная подстилка	[['влажный', {'им,ед'}], ['подстилка', {'им,ед'}]]
влажном мраке	[['влажный', {'пр,ед'}], ['мрак', {'пр,ед'}]]
влажном газе	[['влажный', {'пр,ед'}], ['газ', {'пр,ед', 'дат,ед'}]]
влажную яму	[['влажный', {'вин,ед'}], ['яма', {'вин,ед', 'дат,ед'}]]
влажных биотопах	[['влажный', {'вин,мн', 'род,мн', 'пр,мн'}], ['биотоп', {'пр,мн'}]]
влажных образцов	[['влажный', {'вин,мн', 'род,мн', 'пр,мн'}], ['образец', {'род,мн', 'им,ед', 'ед,кр,муж'}]]
влажного торфа	[['влажный', {'вин,ед', 'род,ед'}], ['торф', {'им,мн', 'вин,мн', 'род,ед'}]]
влажные стенки	[['влажный', {'им,мн', 'вин,мн'}], ['стенка', {'им,мн', 'вин,мн', 'род,ед'}]]
влажных губах	[['влажный', {'вин,мн', 'род,мн', 'пр,мн'}], ['губа', {'род,мн', 'пр,мн'}]]
влажной стенке	[['влажный', {'твор,ед', 'пр,ед', 'дат,ед', 'род,ед'}], ['стенка', {'пр,ед', 'дат,ед'}]]
влажном воздухе	[['влажный', {'пр,ед'}], ['воздух', {'пр,ед'}]]
влажной камер	[['влажный', {'твор,ед', 'пр,ед', 'дат,ед', 'род,ед'}], ['камера', {'род,мн'}]]
влажный асфальт	[['влажный', {'вин,ед', 'им,ед'}], ['асфальт', {'вин,ед', 'им,ед'}]]
влажную подушку	[['влажный', {'вин,ед'}], ['подушка', {'вин,ед'}]]
влажной марли	[['влажный', {'твор,ед', 'пр,ед', 'дат,ед', 'род,ед'}], ['марля', {'им,мн', 'вин,мн', 'род,ед'}]]
влажной природы	[['влажный', {'твор,ед', 'пр,ед', 'дат,ед', 'род,ед'}], ['природа', {'им,мн', 'вин,мн', 'род,ед'}]]
влажный уголь	[['влажный', {'вин,ед', 'им,ед'}], ['уголь', {'вин,ед', 'им,ед'}]]
влажный холодок	[['влажный', {'вин,ед', 'им,ед'}], ['холодок', {'вин,ед', 'им,ед'}]]
влажный воздух	[['влажный', {'вин,ед', 'им,ед'}], ['воздух', {'вин,ед', 'им,ед'}]]
влажному периоду	[['влажный', {'дат,ед'}], ['период', {'дат,ед'}]]
влажной почв	[['влажный', {'твор,ед', 'пр,ед', 'дат,ед', 'род,ед'}], ['почва', {'род,мн'}]]
влажной головой	[['влажный', {'твор,ед', 'пр,ед', 'дат,ед', 'род,ед'}], ['голова', {'род,ед', 'пр,ед', 'дат,ед', 'твор,ед'}]]
влажных полей	[['влажный', {'вин,мн', 'род,мн', 'пр,мн'}], ['поле', {'ед,пов,2-л,сов', 'срав', 'род,мн', 'вин,мн', 'твор,ед'}]]
влажным субтропикам	[['влажный', {'твор,ед', 'дат,мн'}], ['субтропики', {'дат,мн'}]]
влажного бога	[['влажный', {'вин,ед', 'род,ед'}], ['бог', {'вин,ед', 'род,ед'}]]
влажном снегу	[['влажный', {'пр,ед'}], ['снег', {'местн,ед', 'дат,ед', 'парт,ед'}]]
влажную землю	[['влажный', {'вин,ед'}], ['земля', {'вин,ед'}]]
влажную морду	[['влажный', {'вин,ед'}], ['морда', {'вин,ед'}]]
влажное состояние	[['влажный', {'вин,ед', 'им,ед'}], ['состояние', {'вин,ед', 'им,ед'}]]
влажной адиабате	[['влажный', {'твор,ед', 'пр,ед', 'дат,ед', 'род,ед'}], ['адиабата', {'пр,ед', 'дат,ед'}]]
влажных тропиков	[['влажный', {'вин,мн', 'род,мн', 'пр,мн'}], ['тропики', {'род,мн'}]]
влажных впадинах	[['влажный', {'вин,мн', 'род,мн', 'пр,мн'}], ['впадина', {'пр,мн'}]]
влажным поцелуем	[['влажный', {'твор,ед', 'дат,мн'}], ['поцелуй', {'непрош,мн,изъяв,1-л', 'мн,пов,1-л', 'твор,ед'}]]
влажный воротник	[['влажный', {'вин,ед', 'им,ед'}], ['воротник', {'вин,ед', 'им,ед'}]]
влажных листов	[['влажный', {'вин,мн', 'род,мн', 'пр,мн'}], ['лист', {'род,мн'}]]
влажного кокса	[['влажный', {'вин,ед', 'род,ед'}], ['кокс', {'род,ед', 'им,ед'}]]
влажный хлор	[['влажный', {'вин,ед', 'им,ед'}], ['хлор', {'вин,ед', 'им,ед', 'вин,мн', 'род,мн'}]]
влажный лес	[['влажный', {'вин,ед', 'им,ед'}], ['лес', {'вин,ед', 'им,ед', 'род,мн'}]]
влажной мглою	[['влажный', {'твор,ед', 'пр,ед', 'дат,ед', 'род,ед'}], ['мгла', {'твор,ед'}]]
влажным грунтом	[['влажный', {'твор,ед', 'дат,мн'}], ['грунт', {'твор,ед'}]]
влажной кистью	[['влажный', {'твор,ед', 'пр,ед', 'дат,ед', 'род,ед'}], ['кисть', {'твор,ед'}]]
влажными стенами	[['влажный', {'твор,мн'}], ['стена', {'твор,мн'}]]
влажной окиси	[['влажный', {'твор,ед', 'пр,ед', 'дат,ед', 'род,ед'}], ['окись', {'им,мн', 'вин,мн', 'пр,ед', 'дат,ед', 'род,ед'}]]
влажного муссона	[['влажный', {'вин,ед', 'род,ед'}], ['муссон', {'род,ед'}]]
влажной тундры	[['влажный', {'твор,ед', 'пр,ед', 'дат,ед', 'род,ед'}], ['тундра', {'им,мн', 'вин,мн', 'род,ед'}]]
влажным лугом	[['влажный', {'твор,ед', 'дат,мн'}], ['луг', {'твор,ед'}]]
влажных берегов	[['влажный', {'вин,мн', 'род,мн', 'пр,мн'}], ['берег', {'род,мн'}]]
влажнымъ климатомъ	[['влажный', {'твор,ед', 'дат,мн'}], ['климат', {'твор,ед'}]]
влажном снеге	[['влажный', {'пр,ед'}], ['снег', {'пр,ед'}]]
влажную отмель	[['влажный', {'вин,ед'}], ['отмель', {'вин,ед', 'им,ед'}]]
влажный путь	[['влажный', {'вин,ед', 'им,ед'}], ['путь', {'вин,ед', 'им,ед'}]]
влажное дно	[['влажный', {'вин,ед', 'им,ед'}], ['дно', {'вин,ед', 'им,ед'}]]
влажную палубу	[['влажный', {'вин,ед'}], ['палуба', {'вин,ед'}]]
влажный сад	[['влажный', {'вин,ед', 'им,ед'}], ['сад', {'вин,ед', 'им,ед'}]]
влажного неба	[['влажный', {'вин,ед', 'род,ед'}], ['небо', {'им,мн', 'вин,мн', 'род,ед'}]]
влажный рот	[['влажный', {'вин,ед', 'им,ед'}], ['рот', {'вин,ед', 'им,ед', 'род,мн'}]]
влажную шею	[['влажный', {'вин,ед'}], ['шея', {'вин,ед'}]]
влажную салфетку	[['влажный', {'вин,ед'}], ['салфетка', {'вин,ед'}]]
влажного материала	[['влажный', {'вин,ед', 'род,ед'}], ['материал', {'род,ед'}]]
влажные простыни	[['влажный', {'им,мн', 'вин,мн'}], ['простыня', {'им,мн', 'вин,мн', 'род,ед'}]]
влажным камням	[['влажный', {'твор,ед', 'дат,мн'}], ['камень', {'дат,мн'}]]
влажной тропинке	[['влажный', {'твор,ед', 'пр,ед', 'дат,ед', 'род,ед'}], ['тропинка', {'пр,ед', 'дат,ед'}]]
влажной кожей	[['влажный', {'твор,ед', 'пр,ед', 'дат,ед', 'род,ед'}], ['кожа', {'твор,ед'}]]
влажные портянки	[['влажный', {'им,мн', 'вин,мн'}], ['портянка', {'им,мн', 'вин,мн', 'род,ед'}]]
влажные зоны	[['влажный', {'им,мн', 'вин,мн'}], ['зона', {'им,мн', 'вин,мн', 'род,ед'}]]
влажными глазками	[['влажный', {'твор,мн'}], ['глазок', {'твор,мн'}]]
влажной зон	[['влажный', {'твор,ед', 'пр,ед', 'дат,ед', 'род,ед'}], ['зона', {'род,мн'}]]
влажной подстилке	[['влажный', {'твор,ед', 'пр,ед', 'дат,ед', 'род,ед'}], ['подстилка', {'пр,ед', 'дат,ед'}]]
влажной листвой	[['влажный', {'твор,ед', 'пр,ед', 'дат,ед', 'род,ед'}], ['листва', {'твор,ед'}]]
влажной глубине	[['влажный', {'твор,ед', 'пр,ед', 'дат,ед', 'род,ед'}], ['глубина', {'пр,ед', 'дат,ед'}]]
влажные стены	[['влажный', {'им,мн', 'вин,мн'}], ['стена', {'им,мн', 'вин,мн', 'род,ед'}]]
влажные кристаллы	[['влажный', {'им,мн', 'вин,мн'}], ['кристалл', {'им,мн', 'вин,мн'}]]
влажными губками	[['влажный', {'твор,мн'}], ['губка', {'твор,мн'}]]
влажной силой	[['влажный', {'твор,ед', 'пр,ед', 'дат,ед', 'род,ед'}], ['сила', {'', 'твор,ед'}]]
влажных тропиках	[['влажный', {'вин,мн', 'род,мн', 'пр,мн'}], ['тропики', {'пр,мн'}]]
влажный кашель	[['влажный', {'вин,ед', 'им,ед'}], ['кашель', {'вин,ед', 'им,ед'}]]
влажного потока	[['влажный', {'вин,ед', 'род,ед'}], ['поток', {'род,ед'}]]
влажной дезинсекции	[['влажный', {'твор,ед', 'пр,ед', 'дат,ед', 'род,ед'}], ['дезинсекция', {'им,мн', 'вин,мн', 'пр,ед', 'дат,ед', 'род,ед'}]]
влажной атмосферой	[['влажный', {'твор,ед', 'пр,ед', 'дат,ед', 'род,ед'}], ['атмосфера', {'твор,ед'}]]
влажный холод	[['влажный', {'вин,ед', 'им,ед'}], ['холод', {'вин,ед', 'им,ед'}]]
влажным платком	[['влажный', {'твор,ед', 'дат,мн'}], ['платок', {'твор,ед'}]]
влажном блеске	[['влажный', {'пр,ед'}], ['блеск', {'пр,ед'}]]
влажного дыхания	[['влажный', {'вин,ед', 'род,ед'}], ['дыхание', {'им,мн', 'вин,мн', 'род,ед'}]]
влажной ткани	[['влажный', {'твор,ед', 'пр,ед', 'дат,ед', 'род,ед'}], ['ткань', {'им,мн', 'вин,мн', 'пр,ед', 'дат,ед', 'род,ед'}]]
влажной камере	[['влажный', {'твор,ед', 'пр,ед', 'дат,ед', 'род,ед'}], ['камера', {'пр,ед', 'дат,ед'}]]
влажные низины	[['влажный', {'им,мн', 'вин,мн'}], ['низина', {'им,мн', 'вин,мн', 'род,ед'}]]
влажными опилками	[['влажный', {'твор,мн'}], ['опилки', {'твор,мн'}]]
влажные слои	[['влажный', {'им,мн', 'вин,мн'}], ['слой', {'им,мн', 'вин,мн', 'ед,пов,2-л'}]]
влажном способе	[['влажный', {'пр,ед'}], ['способ', {'пр,ед'}]]
влажной пленки	[['влажный', {'твор,ед', 'пр,ед', 'дат,ед', 'род,ед'}], ['пленка', {'им,мн', 'вин,мн', 'род,ед'}]]
влажную эпоху	[['влажный', {'вин,ед'}], ['эпоха', {'вин,ед'}]]
влажным суглинком	[['влажный', {'твор,ед', 'дат,мн'}], ['суглинок', {'твор,ед'}]]
влажную мякоть	[['влажный', {'вин,ед'}], ['мякоть', {'вин,ед', 'им,ед'}]]
влажные сумерки	[['влажный', {'им,мн', 'вин,мн'}], ['сумерки', {'им,мн', 'вин,мн'}]]
влажные лица	[['влажный', {'им,мн', 'вин,мн'}], ['лицо', {'им,мн', 'вин,мн', 'род,ед'}]]
влажной землей	[['влажный', {'твор,ед', 'пр,ед', 'дат,ед', 'род,ед'}], ['земля', {'твор,ед'}]]
влажного типа	[['влажный', {'вин,ед', 'род,ед'}], ['тип', {'вин,ед', 'род,ед'}]]
влажных рук	[['влажный', {'вин,мн', 'род,мн', 'пр,мн'}], ['рука', {'род,мн'}]]
влажный муссон	[['влажный', {'вин,ед', 'им,ед'}], ['муссон', {'вин,ед', 'им,ед'}]]
влажную глину	[['влажный', {'вин,ед'}], ['глина', {'вин,ед'}]]
влажной рукою	[['влажный', {'твор,ед', 'пр,ед', 'дат,ед', 'род,ед'}], ['рука', {'твор,ед'}]]
влажному климату	[['влажный', {'дат,ед'}], ['климат', {'дат,ед'}]]
влажную обработку	[['влажный', {'вин,ед'}], ['обработка', {'вин,ед'}]]
влажные комочки	[['влажный', {'им,мн', 'вин,мн'}], ['комочек', {'им,мн', 'вин,мн'}]]
влажные угли	[['влажный', {'им,мн', 'вин,мн'}], ['уголь', {'им,мн', 'вин,мн'}]]
влажные осадки	[['влажный', {'им,мн', 'вин,мн'}], ['осадки', {'им,мн', 'вин,мн', 'род,ед'}]]
влажный грунт	[['влажный', {'вин,ед', 'им,ед'}], ['грунт', {'вин,ед', 'им,ед'}]]
влажная осень	[['влажный', {'им,ед'}], ['осень', {'вин,ед', 'им,ед'}]]
влажной равнине	[['влажный', {'твор,ед', 'пр,ед', 'дат,ед', 'род,ед'}], ['равнина', {'пр,ед', 'дат,ед'}]]
влажный торф	[['влажный', {'вин,ед', 'им,ед'}], ['торф', {'вин,ед', 'им,ед'}]]
влажной атмосферы	[['влажный', {'твор,ед', 'пр,ед', 'дат,ед', 'род,ед'}], ['атмосфера', {'им,мн', 'вин,мн', 'род,ед'}]]
влажную мешковину	[['влажный', {'вин,ед'}], ['мешковина', {'вин,ед'}]]
влажной зимой	[['влажный', {'твор,ед', 'пр,ед', 'дат,ед', 'род,ед'}], ['зима', {'', 'твор,ед'}]]
влажную губку	[['влажный', {'вин,ед'}], ['губка', {'вин,ед'}]]
влажной свежестью	[['влажный', {'твор,ед', 'пр,ед', 'дат,ед', 'род,ед'}], ['свежесть', {'твор,ед'}]]
влажного режима	[['влажный', {'вин,ед', 'род,ед'}], ['режим', {'род,ед'}]]
влажная фаза	[['влажный', {'им,ед'}], ['фаза', {'им,ед'}]]
влажной мглой	[['влажный', {'твор,ед', 'пр,ед', 'дат,ед', 'род,ед'}], ['мгла', {'твор,ед'}]]
влажном холоде	[['влажный', {'пр,ед'}], ['холод', {'пр,ед'}]]
влажное полотенце	[['влажный', {'вин,ед', 'им,ед'}], ['полотенце', {'вин,ед', 'пр,ед', 'им,ед'}]]
влажный луг	[['влажный', {'вин,ед', 'им,ед'}], ['луг', {'вин,ед', 'им,ед', 'род,мн'}]]
влажной руды	[['влажный', {'твор,ед', 'пр,ед', 'дат,ед', 'род,ед'}], ['руда', {'им,мн', 'вин,мн', 'род,ед', 'мн,кр'}]]
влажнаго воздуха	[['влажный', {'устар,вин', 'устар,род'}], ['воздух', {'род,ед'}]]
влажными пальчиками	[['влажный', {'твор,мн'}], ['пальчик', {'твор,мн'}]]
влажный порошок	[['влажный', {'вин,ед', 'им,ед'}], ['порошок', {'вин,ед', 'им,ед'}]]
влажными травами	[['влажный', {'твор,мн'}], ['трава', {'твор,мн'}]]
влажные комья	[['влажный', {'им,мн', 'вин,мн'}], ['ком', {'им,мн', 'вин,мн'}]]
влажным жаром	[['влажный', {'твор,ед', 'дат,мн'}], ['жар', {'твор,ед'}]]
влажных горизонтов	[['влажный', {'вин,мн', 'род,мн', 'пр,мн'}], ['горизонт', {'род,мн'}]]
влажной уборкой	[['влажный', {'твор,ед', 'пр,ед', 'дат,ед', 'род,ед'}], ['уборка', {'твор,ед'}]]
влажных мхов	[['влажный', {'вин,мн', 'род,мн', 'пр,мн'}], ['мох', {'род,мн'}]]
влажный звук	[['влажный', {'вин,ед', 'им,ед'}], ['звук', {'вин,ед', 'им,ед'}]]
влажную руку	[['влажный', {'вин,ед'}], ['рука', {'вин,ед'}]]
влажной смерти	[['влажный', {'твор,ед', 'пр,ед', 'дат,ед', 'род,ед'}], ['смерть', {'им,мн', 'вин,мн', 'пр,ед', 'дат,ед', 'род,ед'}]]
влажных гранул	[['влажный', {'вин,мн', 'род,мн', 'пр,мн'}], ['гранула', {'род,мн'}]]
влажного чернозема	[['влажный', {'вин,ед', 'род,ед'}], ['чернозем', {'род,ед'}]]
влажная муть	[['влажный', {'им,ед'}], ['муть', {'вин,ед', 'им,ед'}]]
влажной саванны	[['влажный', {'твор,ед', 'пр,ед', 'дат,ед', 'род,ед'}], ['саванна', {'им,мн', 'вин,мн', 'род,ед'}]]
влажной салфеткой	[['влажный', {'твор,ед', 'пр,ед', 'дат,ед', 'род,ед'}], ['салфетка', {'твор,ед'}]]
влажных породах	[['влажный', {'вин,мн', 'род,мн', 'пр,мн'}], ['порода', {'пр,мн'}]]
влажным районам	[['влажный', {'твор,ед', 'дат,мн'}], ['район', {'дат,мн'}]]
влажный комок	[['влажный', {'вин,ед', 'им,ед'}], ['комок', {'вин,ед', 'им,ед'}]]
влажные пары	[['влажный', {'им,мн', 'вин,мн'}], ['пара', {'им,мн', 'вин,мн', 'род,ед'}]]
влажные хлопья	[['влажный', {'им,мн', 'вин,мн'}], ['хлопья', {'им,мн', 'вин,мн'}]]
влажным облаком	[['влажный', {'твор,ед', 'дат,мн'}], ['облако', {'твор,ед'}]]
влажную ночь	[['влажный', {'вин,ед'}], ['ночь', {'вин,ед', 'им,ед'}]]
влажными полосками	[['влажный', {'твор,мн'}], ['полоска', {'твор,мн'}]]
влажный микроклимат	[['влажный', {'вин,ед', 'им,ед'}], ['микроклимат', {'вин,ед', 'им,ед'}]]
влажном свете	[['влажный', {'пр,ед'}], ['свет', {'пр,ед', 'дат,ед'}]]
влажная тень	[['влажный', {'им,ед'}], ['тень', {'вин,ед', 'им,ед'}]]
влажных поверхностях	[['влажный', {'вин,мн', 'род,мн', 'пр,мн'}], ['поверхность', {'пр,мн'}]]
влажную сирень	[['влажный', {'вин,ед'}], ['сирень', {'вин,ед', 'им,ед'}]]
влажных вариантов	[['влажный', {'вин,мн', 'род,мн', 'пр,мн'}], ['вариант', {'род,мн'}]]
влажном топливе	[['влажный', {'пр,ед'}], ['топливо', {'пр,ед'}]]
влажной массе	[['влажный', {'твор,ед', 'пр,ед', 'дат,ед', 'род,ед'}], ['масса', {'пр,ед', 'дат,ед'}]]
влажной тряпке	[['влажный', {'твор,ед', 'пр,ед', 'дат,ед', 'род,ед'}], ['тряпка', {'пр,ед', 'дат,ед'}]]
влажная свежесть	[['влажный', {'им,ед'}], ['свежесть', {'вин,ед', 'им,ед'}]]
влажным налетом	[['влажный', {'твор,ед', 'дат,мн'}], ['налет', {'', 'твор,ед'}]]
влажных низинах	[['влажный', {'вин,мн', 'род,мн', 'пр,мн'}], ['низина', {'пр,мн'}]]
влажный узел	[['влажный', {'вин,ед', 'им,ед'}], ['узел', {'вин,ед', 'им,ед'}]]
влажной весне	[['влажный', {'твор,ед', 'пр,ед', 'дат,ед', 'род,ед'}], ['весна', {'пр,ед', 'дат,ед'}]]
влажным лбом	[['влажный', {'твор,ед', 'дат,мн'}], ['лоб', {'твор,ед'}]]
влажной шее	[['влажный', {'твор,ед', 'пр,ед', 'дат,ед', 'род,ед'}], ['шея', {'пр,ед', 'дат,ед'}]]
влажного суглинка	[['влажный', {'вин,ед', 'род,ед'}], ['суглинок', {'род,ед'}]]
влажный сквозняк	[['влажный', {'вин,ед', 'им,ед'}], ['сквозняк', {'вин,ед', 'им,ед'}]]
влажных местностях	[['влажный', {'вин,мн', 'род,мн', 'пр,мн'}], ['местность', {'пр,мн'}]]
влажные стебли	[['влажный', {'им,мн', 'вин,мн'}], ['стебель', {'им,мн', 'вин,мн'}]]
влажной весной	[['влажный', {'твор,ед', 'пр,ед', 'дат,ед', 'род,ед'}], ['весна', {'', 'твор,ед'}]]
влажным годам	[['влажный', {'твор,ед', 'дат,мн'}], ['год', {'дат,мн'}]]
влажная губа	[['влажный', {'им,ед'}], ['губа', {'им,ед'}]]
влажных низин	[['влажный', {'вин,мн', 'род,мн', 'пр,мн'}], ['низина', {'род,мн'}]]
влажных периода	[['влажный', {'вин,мн', 'род,мн', 'пр,мн'}], ['период', {'род,ед'}]]
влажного сумрака	[['влажный', {'вин,ед', 'род,ед'}], ['сумрак', {'род,ед'}]]
влажному снегу	[['влажный', {'дат,ед'}], ['снег', {'местн,ед', 'дат,ед', 'парт,ед'}]]
влажными углами	[['влажный', {'твор,мн'}], ['угол', {'твор,мн'}]]
влажной степи	[['влажный', {'твор,ед', 'пр,ед', 'дат,ед', 'род,ед'}], ['степь', {'им,мн', 'вин,мн', 'пр,ед', 'дат,ед', 'род,ед'}]]
влажные ветки	[['влажный', {'им,мн', 'вин,мн'}], ['ветка', {'им,мн', 'вин,мн', 'род,ед'}]]
влажным хладом	[['влажный', {'твор,ед', 'дат,мн'}], ['хлад', {'твор,ед'}]]
влажных глыб	[['влажный', {'вин,мн', 'род,мн', 'пр,мн'}], ['глыба', {'род,мн'}]]
влажным торфом	[['влажный', {'твор,ед', 'дат,мн'}], ['торф', {'твор,ед'}]]
влажной фазы	[['влажный', {'твор,ед', 'пр,ед', 'дат,ед', 'род,ед'}], ['фаза', {'им,мн', 'вин,мн', 'род,ед'}]]
влажному асфальту	[['влажный', {'дат,ед'}], ['асфальт', {'дат,ед'}]]
влажном небе	[['влажный', {'пр,ед'}], ['небо', {'пр,ед'}]]
влажный вечер	[['влажный', {'вин,ед', 'им,ед'}], ['вечер', {'вин,ед', 'им,ед'}]]
влажном субстрате	[['влажный', {'пр,ед'}], ['субстрат', {'пр,ед'}]]
влажного дефицита	[['влажный', {'вин,ед', 'род,ед'}], ['дефицит', {'род,ед'}]]
влажный бор	[['влажный', {'вин,ед', 'им,ед'}], ['бор', {'вин,ед', 'им,ед', 'род,мн'}]]
влажном угле	[['влажный', {'пр,ед'}], ['угол', {'пр,ед'}]]
влажной трухе	[['влажный', {'твор,ед', 'пр,ед', 'дат,ед', 'род,ед'}], ['труха', {'пр,ед', 'дат,ед'}]]
влажным шелестом	[['влажный', {'твор,ед', 'дат,мн'}], ['шелест', {'твор,ед'}]]
влажной области	[['влажный', {'твор,ед', 'пр,ед', 'дат,ед', 'род,ед'}], ['область', {'им,мн', 'вин,мн', 'пр,ед', 'дат,ед', 'род,ед'}]]
влажной бездной	[['влажный', {'твор,ед', 'пр,ед', 'дат,ед', 'род,ед'}], ['бездна', {'твор,ед'}]]
влажных биотопов	[['влажный', {'вин,мн', 'род,мн', 'пр,мн'}], ['биотоп', {'род,мн'}]]
влажному воздуху	[['влажный', {'дат,ед'}], ['воздух', {'дат,ед', 'парт,ед'}]]
влажных камней	[['влажный', {'вин,мн', 'род,мн', 'пр,мн'}], ['камень', {'род,мн'}]]
влажное место	[['влажный', {'вин,ед', 'им,ед'}], ['место', {'вин,ед', 'им,ед'}]]
влажным улицам	[['влажный', {'твор,ед', 'дат,мн'}], ['улица', {'дат,мн'}]]
влажных муссонов	[['влажный', {'вин,мн', 'род,мн', 'пр,мн'}], ['муссон', {'род,мн'}]]
влажная полоса	[['влажный', {'им,ед'}], ['полоса', {'им,ед'}]]
влажных масс	[['влажный', {'вин,мн', 'род,мн', 'пр,мн'}], ['масса', {'род,мн'}]]
влажные стекла	[['влажный', {'им,мн', 'вин,мн'}], ['стекло', {'им,мн', 'вин,мн', 'род,ед', 'прош,ед,изъяв,жен,сов'}]]
влажной одежде	[['влажный', {'твор,ед', 'пр,ед', 'дат,ед', 'род,ед'}], ['одежда', {'пр,ед', 'дат,ед'}]]
влажным периодам	[['влажный', {'твор,ед', 'дат,мн'}], ['период', {'дат,мн'}]]
влажный локон	[['влажный', {'вин,ед', 'им,ед'}], ['локон', {'вин,ед', 'им,ед'}]]
влажным звуком	[['влажный', {'твор,ед', 'дат,мн'}], ['звук', {'твор,ед'}]]
влажными кустами	[['влажный', {'твор,мн'}], ['куст', {'твор,мн'}]]
влажным мохом	[['влажный', {'твор,ед', 'дат,мн'}], ['мох', {'твор,ед'}]]
влажную простыню	[['влажный', {'вин,ед'}], ['простыня', {'вин,ед'}]]
влажным тропикам	[['влажный', {'твор,ед', 'дат,мн'}], ['тропики', {'дат,мн'}]]
влажный след	[['влажный', {'вин,ед', 'им,ед'}], ['след', {'', 'вин,ед', 'им,ед'}]]
влажного остатка	[['влажный', {'вин,ед', 'род,ед'}], ['остаток', {'род,ед'}]]
влажных местообитаниях	[['влажный', {'вин,мн', 'род,мн', 'пр,мн'}], ['местообитание', {'пр,мн'}]]
влажного бетона	[['влажный', {'вин,ед', 'род,ед'}], ['бетон', {'род,ед'}]]
влажных цветов	[['влажный', {'вин,мн', 'род,мн', 'пр,мн'}], ['цветок', {'род,мн'}]]
влажномъ климате	[['влажный', {'пр,ед'}], ['климат', {'пр,ед'}]]
влажную бурку	[['влажный', {'вин,ед'}], ['бурка', {'вин,ед'}]]
влажное белье	[['влажный', {'вин,ед', 'им,ед'}], ['белье', {'вин,ед', 'пр,ед', 'им,ед'}]]
влажного песка	[['влажный', {'вин,ед', 'род,ед'}], ['песок', {'род,ед'}]]
влажного тела	[['влажный', {'вин,ед', 'род,ед'}], ['тело', {'им,мн', 'вин,мн', 'род,ед'}]]
влажных пятен	[['влажный', {'вин,мн', 'род,мн', 'пр,мн'}], ['пятно', {'род,мн'}]]
влажных участков	[['влажный', {'вин,мн', 'род,мн', 'пр,мн'}], ['участок', {'род,мн', 'ед,кр,муж'}]]
влажной прохладой	[['влажный', {'твор,ед', 'пр,ед', 'дат,ед', 'род,ед'}], ['прохлада', {'твор,ед'}]]
влажной пробы	[['влажный', {'твор,ед', 'пр,ед', 'дат,ед', 'род,ед'}], ['проба', {'им,мн', 'вин,мн', 'род,ед'}]]
влажных лесов	[['влажный', {'вин,мн', 'род,мн', 'пр,мн'}], ['лес', {'род,мн'}]]
влажные куски	[['влажный', {'им,мн', 'вин,мн'}], ['кусок', {'им,мн', 'вин,мн'}]]
влажным местам	[['влажный', {'твор,ед', 'дат,мн'}], ['место', {'дат,мн'}]]
влажных адиабат	[['влажный', {'вин,мн', 'род,мн', 'пр,мн'}], ['адиабата', {'род,мн'}]]
влажную щеку	[['влажный', {'вин,ед'}], ['щека', {'вин,ед'}]]
влажную массу	[['влажный', {'вин,ед'}], ['масса', {'вин,ед'}]]
влажной ваты	[['влажный', {'твор,ед', 'пр,ед', 'дат,ед', 'род,ед'}], ['вата', {'им,мн', 'вин,мн', 'род,ед'}]]
влажной дымки	[['влажный', {'твор,ед', 'пр,ед', 'дат,ед', 'род,ед'}], ['дымка', {'им,мн', 'вин,мн', 'род,ед'}]]
влажный жар	[['влажный', {'вин,ед', 'им,ед'}], ['жар', {'вин,ед', 'им,ед'}]]
влажных лет	[['влажный', {'вин,мн', 'род,мн', 'пр,мн'}], ['год', {'род,мн', 'вин,ед', 'им,ед'}]]
влажными пятнами	[['влажный', {'твор,мн'}], ['пятно', {'твор,мн'}]]
влажной камерой	[['влажный', {'твор,ед', 'пр,ед', 'дат,ед', 'род,ед'}], ['камера', {'твор,ед'}]]
влажномъ воздухе	[['влажный', {'пр,ед'}], ['воздух', {'пр,ед'}]]
влажном периоде	[['влажный', {'пр,ед'}], ['период', {'пр,ед'}]]
влажном черноземе	[['влажный', {'пр,ед'}], ['чернозем', {'пр,ед'}]]
влажной теплотой	[['влажный', {'твор,ед', 'пр,ед', 'дат,ед', 'род,ед'}], ['теплота', {'твор,ед'}]]
влажными семенами	[['влажный', {'твор,мн'}], ['семя', {'твор,мн'}]]
влажному дыханию	[['влажный', {'дат,ед'}], ['дыхание', {'дат,ед'}]]
влажные массы	[['влажный', {'им,мн', 'вин,мн'}], ['масса', {'им,мн', 'вин,мн', 'род,ед'}]]
влажных субстратах	[['влажный', {'вин,мн', 'род,мн', 'пр,мн'}], ['субстрат', {'пр,мн'}]]
влажных ельниках	[['влажный', {'вин,мн', 'род,мн', 'пр,мн'}], ['ельник', {'пр,мн'}]]
влажных грунтах	[['влажный', {'вин,мн', 'род,мн', 'пр,мн'}], ['грунт', {'пр,мн'}]]
влажною землей	[['влажный', {'твор,ед'}], ['земля', {'твор,ед'}]]
влажными полями	[['влажный', {'твор,мн'}], ['поле', {'твор,мн'}]]
влажная обработка	[['влажный', {'им,ед'}], ['обработка', {'им,ед'}]]
влажного весла	[['влажный', {'вин,ед', 'род,ед'}], ['весло', {'им,мн', 'вин,мн', 'род,ед'}]]
влажные тряпки	[['влажный', {'им,мн', 'вин,мн'}], ['тряпка', {'им,мн', 'вин,мн', 'род,ед'}]]
влажным режимом	[['влажный', {'твор,ед', 'дат,мн'}], ['режим', {'непрош,пр,ед,прич,полн,сред,страд', 'непрош,пр,ед,прич,полн,муж,страд', 'твор,ед'}]]
влажной уборке	[['влажный', {'твор,ед', 'пр,ед', 'дат,ед', 'род,ед'}], ['уборка', {'пр,ед', 'дат,ед'}]]
влажных волос	[['влажный', {'вин,мн', 'род,мн', 'пр,мн'}], ['волос', {'вин,ед', 'род,мн', 'им,ед'}]]
влажный поток	[['влажный', {'вин,ед', 'им,ед'}], ['поток', {'вин,ед', 'им,ед'}]]
влажные укутывания	[['влажный', {'им,мн', 'вин,мн'}], ['укутывание', {'им,мн', 'вин,мн', 'род,ед'}]]
влажного тепла	[['влажный', {'вин,ед', 'род,ед'}], ['тепло', {'ед,кр,жен', 'род,ед'}]]
влажный субстрат	[['влажный', {'вин,ед', 'им,ед'}], ['субстрат', {'вин,ед', 'им,ед'}]]
влажного аммиака	[['влажный', {'вин,ед', 'род,ед'}], ['аммиак', {'род,ед'}]]
влажными хрипами	[['влажный', {'твор,мн'}], ['хрип', {'твор,мн'}]]
влажную древесину	[['влажный', {'вин,ед'}], ['древесина', {'вин,ед'}]]
влажном горизонте	[['влажный', {'пр,ед'}], ['горизонт', {'пр,ед'}]]
влажному термометрам	[['влажный', {'дат,ед'}], ['термометр', {'дат,мн'}]]
влажного крахмала	[['влажный', {'вин,ед', 'род,ед'}], ['крахмал', {'род,ед'}]]
влажное лоно	[['влажный', {'вин,ед', 'им,ед'}], ['лоно', {'вин,ед', 'им,ед'}]]
влажным климатом	[['влажный', {'твор,ед', 'дат,мн'}], ['климат', {'твор,ед'}]]
влажной поверхностью	[['влажный', {'твор,ед', 'пр,ед', 'дат,ед', 'род,ед'}], ['поверхность', {'твор,ед'}]]
влажном мхе	[['влажный', {'пр,ед'}], ['мох', {'пр,ед'}]]
влажный материал	[['влажный', {'вин,ед', 'им,ед'}], ['материал', {'вин,ед', 'им,ед'}]]
влажный корм	[['влажный', {'вин,ед', 'им,ед'}], ['корм', {'вин,ед', 'им,ед', 'род,мн'}]]
влажная древесина	[['влажный', {'им,ед'}], ['древесина', {'им,ед'}]]
влажную солому	[['влажный', {'вин,ед'}], ['солома', {'вин,ед'}]]
влажные периоды	[['влажный', {'им,мн', 'вин,мн'}], ['период', {'им,мн', 'вин,мн'}]]
влажными ладонями	[['влажный', {'твор,мн'}], ['ладонь', {'твор,мн'}]]
влажной тропе	[['влажный', {'твор,ед', 'пр,ед', 'дат,ед', 'род,ед'}], ['тропа', {'пр,ед', 'дат,ед'}]]
влажными салфетками	[['влажный', {'твор,мн'}], ['салфетка', {'твор,мн'}]]
влажным блеском	[['влажный', {'твор,ед', 'дат,мн'}], ['блеск', {'твор,ед'}]]
влажный взглядъ	[['влажный', {'вин,ед', 'им,ед'}], ['взгляд', {'вин,ед', 'им,ед'}]]
влажные типы	[['влажный', {'им,мн', 'вин,мн'}], ['тип', {'им,мн', 'вин,мн'}]]
влажными корнями	[['влажный', {'твор,мн'}], ['корень', {'твор,мн'}]]
влажными местообитаниями	[['влажный', {'твор,мн'}], ['местообитание', {'твор,мн'}]]
влажная ночь	[['влажный', {'им,ед'}], ['ночь', {'вин,ед', 'им,ед'}]]
влажное начало	[['влажный', {'вин,ед', 'им,ед'}], ['начало', {'вин,ед', 'им,ед', 'прош,ед,изъяв,сред,сов'}]]
влажном паре	[['влажный', {'пр,ед'}], ['пара', {'пр,ед', 'дат,ед'}]]
влажном корме	[['влажный', {'пр,ед'}], ['корма', {'пр,ед', 'дат,ед'}]]
влажных пастбищах	[['влажный', {'вин,мн', 'род,мн', 'пр,мн'}], ['пастбище', {'пр,мн'}]]
влажный волос	[['влажный', {'вин,ед', 'им,ед'}], ['волос', {'вин,ед', 'род,мн', 'им,ед'}]]
влажного вороха	[['влажный', {'вин,ед', 'род,ед'}], ['ворох', {'им,мн', 'вин,мн', 'род,ед'}]]
влажным дымом	[['влажный', {'твор,ед', 'дат,мн'}], ['дым', {'твор,ед'}]]
влажные берега	[['влажный', {'им,мн', 'вин,мн'}], ['берег', {'им,мн', 'вин,мн', 'род,ед'}]]
влажных стациях	[['влажный', {'вин,мн', 'род,мн', 'пр,мн'}], ['стация', {'пр,мн'}]]
влажный продукт	[['влажный', {'вин,ед', 'им,ед'}], ['продукт', {'вин,ед', 'им,ед'}]]
влажные дубравы	[['влажный', {'им,мн', 'вин,мн'}], ['дубрава', {'им,мн', 'вин,мн', 'род,ед'}]]
влажными запахами	[['влажный', {'твор,мн'}], ['запах', {'твор,мн'}]]
влажные ветры	[['влажный', {'им,мн', 'вин,мн'}], ['ветер', {'им,мн', 'вин,мн'}]]
влажном азоте	[['влажный', {'пр,ед'}], ['азот', {'пр,ед'}]]
влажные образцы	[['влажный', {'им,мн', 'вин,мн'}], ['образец', {'им,мн', 'вин,мн'}]]
влажное поле	[['влажный', {'вин,ед', 'им,ед'}], ['поле', {'вин,ед', 'пр,ед', 'им,ед', 'дат,ед'}]]
влажные климаты	[['влажный', {'им,мн', 'вин,мн'}], ['климат', {'им,мн', 'вин,мн'}]]
влажном грунте	[['влажный', {'пр,ед'}], ['грунт', {'пр,ед'}]]
влажного бора	[['влажный', {'вин,ед', 'род,ед'}], ['бор', {'род,ед', 'им,ед'}]]
влажная галька	[['влажный', {'им,ед'}], ['галька', {'вин,ед', 'им,ед', 'род,ед'}]]
влажной его	[['влажный', {'твор,ед', 'пр,ед', 'дат,ед', 'род,ед'}], ['он=SPRO,ед,3-л,муж=вин', {'им,ед,муж', 'род,мн,сред', 'дат,ед,муж', 'дат,ед,сред', 'вин,ед,жен', 'пр,мн', 'вин,мн,од', 'род,мн', 'им,ед,сред', 'вин,ед', 'вин,мн,сред', 'им,ед,жен', 'вин,ед,муж', 'твор,ед,жен', 'дат,мн,муж', 'пр,ед,жен', 'вин,ед,муж,неод', 'вин,мн,муж', 'вин,мн,неод', 'твор,ед,муж', 'дат,мн,сред', 'им,мн', 'пр,мн,сред', 'твор,мн', 'дат,ед,жен', 'пр,мн,муж', 'род,ед,жен', 'твор,ед,сред', 'вин,ед,сред', 'род,ед,муж', 'дат,мн', 'род,ед,сред', 'вин,ед,муж,од', 'пр,ед,муж', 'пр,ед,сред', 'им,мн,сред', 'род,ед', 'твор,мн,сред'}]]
влажных ветвей	[['влажный', {'вин,мн', 'род,мн', 'пр,мн'}], ['ветвь', {'род,мн'}]]
влажный кислород	[['влажный', {'вин,ед', 'им,ед'}], ['кислород', {'вин,ед', 'им,ед'}]]
влажном сумраке	[['влажный', {'пр,ед'}], ['сумрак', {'пр,ед'}]]
влажные тени	[['влажный', {'им,мн', 'вин,мн'}], ['тень', {'им,мн', 'вин,мн', 'род,ед', 'пр,ед', 'дат,ед', 'ед,пов,2-л'}]]
влажных отходов	[['влажный', {'вин,мн', 'род,мн', 'пр,мн'}], ['отходы', {'род,мн'}]]
влажных потоков	[['влажный', {'вин,мн', 'род,мн', 'пр,мн'}], ['поток', {'род,мн', 'им,ед'}]]
влажной соломе	[['влажный', {'твор,ед', 'пр,ед', 'дат,ед', 'род,ед'}], ['солома', {'пр,ед', 'дат,ед'}]]
влажную спину	[['влажный', {'вин,ед'}], ['спина', {'вин,ед', 'дат,ед'}]]
влажной целлюлозы	[['влажный', {'твор,ед', 'пр,ед', 'дат,ед', 'род,ед'}], ['целлюлоза', {'им,мн', 'вин,мн', 'род,ед'}]]
влажной очистки	[['влажный', {'твор,ед', 'пр,ед', 'дат,ед', 'род,ед'}], ['очистка', {'им,мн', 'вин,мн', 'род,ед'}]]
влажную пелену	[['влажный', {'вин,ед'}], ['пелена', {'вин,ед'}]]
влажным глазам	[['влажный', {'твор,ед', 'дат,мн'}], ['глаз', {'дат,мн'}]]
влажной зоны	[['влажный', {'твор,ед', 'пр,ед', 'дат,ед', 'род,ед'}], ['зона', {'им,мн', 'вин,мн', 'род,ед'}]]
влажной землею	[['влажный', {'твор,ед', 'пр,ед', 'дат,ед', 'род,ед'}], ['земля', {'твор,ед'}]]
влажный лист	[['влажный', {'вин,ед', 'им,ед'}], ['лист', {'вин,ед', 'им,ед'}]]
влажным ветрам	[['влажный', {'твор,ед', 'дат,мн'}], ['ветер', {'дат,мн'}]]
влажных р	[['влажный', {'вин,мн', 'род,мн', 'пр,мн'}], ['р', {'вин,ед', 'дат,мн', 'им,мн', 'вин,мн', 'твор,мн', 'им,ед', 'пр,мн', 'твор,ед', 'род,мн', 'род,ед', 'дат,ед', 'пр,ед'}]]
влажных ветках	[['влажный', {'вин,мн', 'род,мн', 'пр,мн'}], ['ветка', {'пр,мн'}]]
влажные травы	[['влажный', {'им,мн', 'вин,мн'}], ['трава', {'им,мн', 'вин,мн', 'род,ед'}]]
влажное лицо	[['влажный', {'вин,ед', 'им,ед'}], ['лицо', {'вин,ед', 'им,ед'}]]
влажный кончик	[['влажный', {'вин,ед', 'им,ед'}], ['кончик', {'вин,ед', 'им,ед'}]]
влажную тяжесть	[['влажный', {'вин,ед'}], ['тяжесть', {'вин,ед', 'им,ед'}]]
влажный способ	[['влажный', {'вин,ед', 'им,ед'}], ['способ', {'вин,ед', 'им,ед'}]]
